垢	あか	"때, 물때"	
顎	あご	턱	
麻	あさ	"삼, 삼베"	
脚	あし	(사람의) 다리	
値	あたい	"값어치, 가치, ~할 만함"	
当て	あて	"목표, 기대, 전망"	
網	あみ	"그물, 망"	
過ち	あやまち	"잘못, 실수"	
意	い	"뜻, 마음"	
異	い	"다름, 틀림"	
頂	いただき	"꼭대기, 정상"	
渦	うず	소용돌이	
疑い	うたがい	"의심, 혐의"	
器	うつわ	"그릇, 용기"	
裏	うら	"뒷면, 안감"	
潤い	うるおい	"습기, 보탬, 혜택"	
柄	え	"자루, 손잡이"	
尾	お	꼬리	
公	おおやけ	"공, 공공, 공정함"	
雄	おす	동물의 수컷	
恐れ	おそれ	두려움	
乙	おつ	을	
お宮	おみや	신사	
趣	おもむき	"풍취, 멋"	
核	かく	핵	
頭	かしら	"머리, 두목, 우두머리"	
角	かど	"모서리, 모퉁이"	
狩り	かり	사냥	
官	かん	"관, 관리, 관직"	
癌	がん	암	
絆	きずな	"고삐, 정, 인연, 유대"	
茎	くき	줄기	
管	くだ	"관, 대롱"	
蔵	くら	"곳간, 창고"	
形	けい	형	
芸	げい	"연예, 재주"	
汚れ	けがれ・よごれ	더러움	
獣	けもの	짐승	
甲	こう	갑	
志	こころざし	"뜻, 마음"	
暦	こよみ	달력	
凝り	こり	"뻐근함, 결림"	
杯	さかずき	술잔	
柵	さく	울타리	
策	さく	"책략, 계략"	
様	さま	"모양, 상태, 모습"	
侍	さむらい	무사	
酸	さん	산	
潮	しお	"조수, 밀물, 썰물, 바닷물"	
軸	じく	"축, 굴대"	
種	しゅ	"종, 종류, 종자"	
衆	しゅう	많은 사람	
末	すえ	"말, 사물의 끝"	
膳	ぜん	"밥상, 음식상"	
禅	ぜん	선	
相	そう	"상, 모습"	
僧	そう	승려	
隊	たい	부대	
丈	たけ	"키, 기장, 길이"	
盾	たて	방패	
魂	たましい	"영혼, 정신"	
宙	ちゅう	"공중, 하늘"	
腸	ちょう	창자	
対	つい	쌍	
筒	つつ	"통, 속이 비고 긴 관"	
角	つの	뿔	
露	つゆ	이슬	
棟	とう	"동, 집의 수를 세는 말"	
胴	どう	"몸통, 몸의 중앙부"	
扉	とびら	문	
供	とも	수행원	
情け	なさけ	"정, 인정"	
鉛	なまり	납	
並	なみ	"보통, 중간"	
賑わい	にぎわい	"흥청거림, 번화한"	
尿	にょう	"오줌, 소변"	
主	ぬし	"주인, 가장"	
沼	ぬま	늪	
音	ね	소리	
念	ねん	"생각, 마음, 주의함"	
延	のべ	"연, 총계"	
呪い	のろい	저주	
刃	は	(칼 따위의) 날	
肺	はい	폐	
恥	はじ	"부끄러움, 수치, 치욕, 창피"	
旗	はた	깃발	
罰	ばつ	벌	
果て	はて	"끝, 말로"	
浜	はま	"호숫가, 바닷가"	
班	はん	"반, 조"	
判	はん	도장	
碑	ひ	"비, 비석, 비문"	
票	ひょう	"표, 명찰, 쪽지"	
封	ふう	봉함	
房	ふさ	① (여러 가닥의 실로 만든) 술 ② (포도 등의) 송이	
節	ふし	"마디, 관절"	
札	ふだ	"표찰, 표"	
穂	ほ	이삭	
蛍	ほたる	"개똥벌레, 반디"	
堀	ほり	"수로, (성 둘레에 판) 해자"	
膜	まく	막	
誠	まこと	"진실, 사실, 진심"	
招き	まねき	"초대, 초빙, 초청"	
眉	まゆ	눈썹	
幹	みき	나무의 줄기	
源	みなもと	"수원, 기원, 근원"	
峰	みね	봉우리	
脈	みゃく	"맥, 맥박"	
婿	むこ	사위	
群れ	むれ	"떼, 무리"	
雌	めす	동물의 암컷	
喪	も	"상, 상중"	
矢	や	화살	
闇	やみ	어둠	
優	ゆう	"남보다 뛰어남, (성적) 우"	
弓	ゆみ	활	
世	よ	세상	
欲	よく	욕심	
愛嬌	あいきょう	애교	
愛顧	あいこ	애고(아끼고 돌보아 줌)	
愛惜	あいせき	"애석, 아쉬워함"	
合席	あいせき	"합석, 동석"	
愛想	あいそう・あいそ	"붙임성, 정나미"	
間柄	あいだがら	"관계, 사이"	
合間	あいま	"틈, 짬"	
悪事	あくじ	"나쁜 짓, 악행"	
悪化	あっか	악화	
斡旋	あっせん	"알선, 주선"	
圧倒	あっとう	압도	
圧力	あつりょく	압력	
油絵	あぶらえ	유화	
雨具	あまぐ	우비(우산 · 비옷 등)	
有様	ありさま	"꼴, 모양, 상태"	
暗殺	あんさつ	암살	
暗算	あんざん	암산	
暗示	あんじ	암시	
安静	あんせい	안정	
暗黙	あんもく	암묵	
家柄	いえがら	"집안, 가문"	
家路	いえじ	"(집으로의) 귀로, 귀가"	
家出	いえで	가출	
異議	いぎ	이의	
依拠	いきょ	의거	
育成	いくせい	육성	
幾多	いくた	"많음, 다수"	
異見	いけん	이견	
威厳	いげん	위엄	
意向	いこう	의향	
委細	いさい	자세한 사정	
異彩	いさい	이채	
遺産	いさん	유산	
意地	いじ	고집	
移住	いじゅう	이주	
萎縮	いしゅく	위축	
衣装	いしょう	의상	
異常	いじょう	이상(함)	
依存	いそん・いぞん	의존	
委託	いたく	위탁	
一時	いちじ	"한동안, 한때, 잠시"	
一途	いちず	"외곬, 한결같음"	
一抹	いちまつ	"일말, 아주 약간"	
一目	いちもく	"한 번 봄, 슬쩍 봄"	
一躍	いちやく	일약	
一様	いちよう	"똑같음, 한결같음"	
一括	いっかつ	일괄	
一気	いっき	"한 번의 호흡, 단숨"	
一挙	いっきょ	"일거, 한 번의 행동"	
一色	いっしょく	"일색, ~뿐임"	
一斉	いっせい	"일제, 동시"	
一掃	いっそう	"일소, 한꺼번에 없앰"	
一帯	いったい	일대	
逸品	いっぴん	"일품, 걸작품"	
一変	いっぺん	"일변, 완전히 달라짐"	
逸話	いつわ	일화	
稲光	いなびかり	번개	
稲妻	いなずま	번개	
威力	いりょく	위력	
衣類	いるい	의류	
違和感	いわかん	위화감	
印鑑	いんかん	인감	
隠居	いんきょ	은거	
咽喉	いんこう	"인후, 목, 목구멍"	
印象	いんしょう	인상	
引率	いんそつ	인솔	
隠蔽	いんぺい	음폐	
陰謀	いんぼう	음모	
有無	うむ	유무	
浮気	うわき	바람기	
運営	うんえい	운영	
運賃	うんちん	운임	
云々	うんぬん	운운	
運搬	うんぱん	운반	
運輸	うんゆ	운수	
運用	うんよう	운용	
衛星	えいせい	위성	
衛生	えいせい	위생	
英断	えいだん	영단(지혜롭게 결당함)	
英知	えいち	"예지, 뛰어난 지혜"	
鋭敏	えいびん	예민(함)	
英雄	えいゆう	영웅	
栄養	えいよう	영양	
笑顔	えがお	웃는 얼굴	
疫病	えきびょう	"역병, 돌림병"	
会釈	えしゃく	가볍게 인사함	
会得	えとく	터득	
獲物	えもの	"어획물, 사냥감"	
縁側	えんがわ	툇마루	
沿岸	えんがん	연안	
演劇	えんげき	연극	
遠征	えんせい	원정	
沿線	えんせん	"연선, (버스 · 지하철의) 노선 주변"	
縁談	えんだん	혼담	
応急	おうきゅう	응급	
横行	おうこう	"횡행, 활개침, 난무함"	
黄金	おうごん	황금	
往診	おうしん	왕진	
大口	おおぐち	"큰 입, 큰소리, 거액"	
大損	おおぞん	큰 손해	
お菓子	おかし	과자	
汚職	おしょく	"독직, 공직자의 비리"	
汚辱	おじょく	"오욕, 수치"	
恩恵	おんけい	은혜	
温暖	おんだん	온난	
穏便	おんびん	"온당하고 원만함, 모나지 않음"	
改悪	かいあく	개약(고쳐서 도리어 나빠지게 함)	
海運	かいうん	해운	
外貨	がいか	외화	
外観	がいかん	외관	
階級	かいきゅう	계급	
快挙	かいきょ	쾌거	
介護	かいご	간호	
悔恨	かいこん	"회한, 뉘우침"	
開墾	かいこん	개간	
解釈	かいしゃく	해석	
回収	かいしゅう	회수	
懐柔	かいじゅう	회유	
解消	かいしょう	해소	
改善	かいぜん	개선	
階層	かいそう	계층	
慨嘆	がいたん	개탄	
改築	かいちく	개축	
海中	かいちゅう	바다 속	
懐中	かいちゅう	"회중, 주머니 속"	
回虫	かいちゅう	회충	
害虫	がいちゅう	해충	
改訂	かいてい	개정	
街頭	がいとう	"가두, 길거리"	
概念	がいねん	개념	
外泊	がいはく	외박	
海抜	かいばつ	해발	
解放	かいほう	개방	
介抱	かいほう	"간호, 병구완"	
快方	かいほう	(병의) 차도	
解剖	かいぼう	해부	
開幕	かいまく	개막	
皆無	かいむ	"전무, 전혀 없음"	
概要	がいよう	개요	
外来	がいらい	외해	
回覧	かいらん	회람	
海流	かいりゅう	해류	
課外	かがい	과외(정해진 학과 · 과정 이외)	
学芸	がくげい	학예	
格差	かくさ	격차	
拡散	かくさん	확산	
隔週	かくしゅう	격주	
拡充	かくじゅう	확충	
確信	かくしん	확신	
覚醒	かくせい	각성	
学説	がくせつ	학설	
確定	かくてい	확정	
獲得	かくとく	획득	
楽譜	がくふ	악보	
格別	かくべつ	각별함	
確保	かくほ	확보	
革命	かくめい	혁명	
隔離	かくり	격리	
確率	かくりつ	확률	
確立	かくりつ	확립	
家計	かけい	"가계, 생계"	
加減	かげん	"가감, 조절"	
仮説	かせつ	가설	
河川	かせん	하천	
化繊	かせん	화학섬유	
課題	かだい	과제	
片言	かたこと	"한마디의 말, 서투른 말씨"	
家畜	かちく	가축	
割愛	かつあい	할애	
喝采	かっさい	갈채	
合唱	がっしょう	합창	
合奏	がっそう	합주	
合点	がってん	"납득, 수긍"	
過度	かど	과도(정도에 지나침)	
過渡期	かとき	과도기	
株価	かぶか	주가	
株式	かぶしき	주식	
貨幣	かへい	화폐	
過労	かろう	과로	
含意	がんい	함의(어떤 일에 특별한 뜻을 가지게 함)	
眼科	がんか	안과	
眼球	がんきゅう	"안구, 눈알"	
感激	かんげき	감격	
看護	かんご	간호	
刊行	かんこう	간행	
慣行	かんこう	관행	
勧告	かんこく	권고	
監査	かんさ	감사	
換算	かんさん	환산	
監視	かんし	감시	
慣習	かんしゅう	관습	
観衆	かんしゅう	관중	
完熟	かんじゅく	"완숙, 완전히 익음"	
願書	がんしょ	원서	
干渉	かんしょう	간섭	
勘定	かんじょう	"계산, 셈"	
歓声	かんせい	환성	
関税	かんぜい	관세	
岩石	がんせき	암석	
感染	かんせん	감염	
観測	かんそく	관측	
観点	かんてん	관점	
感度	かんど	감도	
勘当	かんどう	의절	
元年	がんねん	원년	
看板	かんばん	간판	
完備	かんび	오나비	
幹部	かんぶ	간부	
勘弁	かんべん	용서함	
感銘	かんめい	감명	
慣用	かんよう	관용(습관적으로 자주 씀)	
寛容	かんよう	관용(너그러움)	
観覧	かんらん	관람	
官吏	かんり	관리	
官僚	かんりょう	관료	
慣例	かんれい	관례	
還暦	かんれき	환갑	
議案	ぎあん	의안	
気概	きがい	기개	
企画	きかく	기획	
季刊	きかん	계간	
器官	きかん	(호흡 · 소화 등의) 기관	
棄却	ききゃく	기각	
帰京	ききょう	귀경	
基金	ききん	기금	
喜劇	きげき	희극	
議決	ぎけつ	의결	
危険	きけん	위험	
棄権	きけん	기권	
起源	きげん	기원	
機構	きこう	(조직의) 기구	
気心	きごころ	본래의 성질이나 생각	
記載	きさい	기재(적어 넣음)	
機材	きざい	기재(기계와 자재)	
器材	きざい	기재(기구와 재료)	
気質	きしつ	"기질, 성향"	
期日	きじつ	기일	
記述	きじゅつ	기술	
気象	きしょう	기상	
気性	きしょう	기일	
偽証	ぎしょう	위증	
傷跡	きずあと	"상처 자국, 흉"	
帰省	きせい	귀성	
既成	きせい	기성	
規制	きせい	규제	
犠牲	ぎせい	희생	
奇跡	きせき	기적	
軌跡	きせき	궤적	
寄贈	きぞう・きそう	기증	
偽造	ぎぞう	위조	
規則	きそく	규칙	
貴族	きぞく	귀족	
議題	ぎだい	의제	
喫煙	きつえん	흡연	
詰問	きつもん	힐문(나무라고 따짐)	
規定	きてい	규정	
起点	きてん	기점	
危篤	きとく	"위독, 중태"	
技能	ぎのう	기능(기술적인 재능)	
気迫	きはく	기백	
気風	きふう	기풍	
期末	きまつ	기말	
義務	ぎむ	의무	
規約	きやく	규약	
脚色	きゃくしょく	각색	
逆接	ぎゃくせつ	역접	
逆転	ぎゃくてん	역전	
逆流	ぎゃくりゅう	역류	
客観	きゃっかん	객관	
逆境	ぎゃっきょう	역경	
救援	きゅうえん	구원	
究極	きゅうきょく	궁극	
球根	きゅうこん	"구근, 알뿌리"	
救済	きゅうさい	구제	
給仕	きゅうじ	"급사, 사환"	
吸収	きゅうしゅう	흡수	
給食	きゅうしょく	급식	
休戦	きゅうせん	휴전	
宮殿	きゅうでん	궁전	
旧弊	きゅうへい	"구습에서 오는 폐단, 생각이 고루함"	
急変	きゅうへん	급변	
窮乏	きゅうぼう	궁핍	
急務	きゅうむ	"급선무, 급한 일"	
究明	きゅうめい	"구명, 규명"	
休養	きゅうよう	휴양	
驚異	きょうい	경이	
脅威	きょうい	위협	
教科	きょうか	교과	
協会	きょうかい	협회	
共感	きょうかん	공감	
協議	きょうぎ	협의	
供給	きょうきゅう	공급	
境遇	きょうぐう	"경우, 처지, 형편"	
強行	きょうこう	강행	
凶作	きょうさく	흉작	
業者	ぎょうしゃ	업자	
享受	きょうじゅ	"향수, 누림"	
業種	ぎょうしゅ	업종	
教習	きょうしゅう	교습	
郷愁	きょうしゅう	향수(고향을 그리는 마음)	
恐縮	きょうしゅく	죄송스럽게 여김	
供述	きょうじゅつ	"공술, 진술"	
教職	きょうしょく	교직	
強制	きょうせい	강제	
行政	ぎょうせい	행정	
共存	きょうそん・きょうぞん	공존	
境地	きょうち	경지	
協調	きょうちょう	협조	
協定	きょうてい	협정	
郷土	きょうど	향토	
脅迫	きょうはく	협박	
業務	ぎょうむ	업무	
共鳴	きょうめい	"① 공영, 공진 ② 공감함"	
供与	きょうよ	"공여, 제공"	
郷里	きょうり	"향리, 고향"	
局限	きょくげん	국한	 
極限	きょくげん	극한	
局面	きょくめん	"국면, 형세"	
挙行	きょこう	거행	
挙式	きょしき	"거식, 결혼식을 올림"	
居住	きょじゅう	거주	
拒絶	きょぜつ	거절	
漁船	ぎょせん	어선	
漁村	ぎょそん	어촌	
許容	きょよう	허용	
巨利	きょり	큰 이익	
義理	ぎり	의리	
気流	きりゅう	기류	
疑惑	ぎわく	의혹	
近眼	きんがん	근시	
禁忌	きんき	금기	
緊急	きんきゅう	긴급	
近郊	きんこう	근교	
均衡	きんこう	균형	
筋骨	きんこつ	"근골, 체격"	
僅差	きんさ	근소한 차이	
緊縮	きんしゅく	긴축	
筋肉	きんにく	근육	
近年	きんねん	"근년, 근래"	
勤勉	きんべん	근면	
勤労	きんろう	근로	
偶然	ぐうぜん	우연	
空腹	くうふく	공복	
寓話	ぐうわ	우화	
草花	くさばな	화초	
駆除	くじょ	구제(몰아내 없앰)	
苦戦	くせん	고전	
屈折	くっせつ	굴절	
苦杯	くはい	"고배, 쓴 잔, 쓰라린 경험"	
暗闇	くらやみ	"어둠, 어두운 곳"	
軍艦	ぐんかん	군함	
群集	ぐんしゅう	군집	
軍縮	ぐんしゅく	"군축, 군비 축소"	
経緯	けいい	경위	
経験	けいけん	경험	
軽減	けいげん	경감	
警護	けいご	경호	
携行	けいこう	"가지고 다님, 휴대"	
迎合	げいごう	영합(남의 마음에 들도록 힘씀)	
警告	けいこく	경고	
警察	けいさつ	경찰	
軽視	けいし	경시	
形成	けいせい	형성	
形跡	けいせき	"흔적, 자취"	
軽装	けいそう	"경장, 간편한 옷차림"	
形態	けいたい	형태	
境内	けいだい	(신사 · 절의) 경내	
啓発	けいはつ	계발	
刑罰	けいばつ	형벌	
警部	けいぶ	경부(우리 나라의 경장에 상당)	
計略	けいりゃく	계략	
激減	げきげん	"격감, 극감"	
劇団	げきだん	극단	
撃墜	げきつい	격추	
激怒	げきど	격노	
決意	けつい	결의	
結核	けっかく	결핵	
血管	けっかん	혈관	
決議	けつぎ	결의	
欠勤	けっきん	결근	
決行	けっこう	결행	
結合	けつごう	결합	
月謝	げっしゃ	"월사(금), 사례금"	
決勝	けっしょう	결승	
結晶	けっしょう	(눈이나 땀의) 결정	
結成	けっせい	결성	
潔白	けっぱく	결백	
月賦	げっぷ	월부	
欠乏	けつぼう	결핍	
結末	けつまつ	결말	
気配	けはい	"낌새, 기운"	
仮病	けびょう	꾀병	
家来	けらい	"가신, 하인, 부하"	
下痢	げり	설사	
険悪	けんあく	험악	
検挙	けんきょ	검거	
兼業	けんぎょう	겸업	
厳禁	げんきん	엄금	
権限	けんげん	권한	
現行	げんこう	현행	
健在	けんざい	건재	
検索	けんさく	검색	
原作	げんさく	원작	
検察	けんさつ	검찰	
検事	けんじ	검사	
厳守	げんしゅ	엄수	
元首	げんしゅ	(국가) 원수	
健勝	けんしょう	건승	
懸賞	けんしょう	현상(상금이나 상품을 내걸음)	
厳選	げんせん	엄선	
源泉	げんせん	원천	
元素	げんそ	원소	
幻想	げんそう	환상	
現像	げんぞう	(필름 등) 현상	
減速	げんそく	감속	
原則	げんそく	원칙	
減退	げんたい	감퇴	
見地	けんち	견지	
減点	げんてん	감점	
原典	げんてん	원전(기준이 되는 본래의 책)	
原点	げんてん	원점	
検討	けんとう	검토	
健闘	けんとう	건투	
原爆	げんばく	"원폭, 원자폭탄"	
原文	げんぶん	원문	
倹約	けんやく	"검약, 절약"	
原油	げんゆ	원유	
兼用	けんよう	겸용	
権力	けんりょく	권력	
言論	げんろん	언론	
行為	こうい	행위	
交易	こうえき	교역	
航海	こうかい	항해	
後悔	こうかい	후회	
公開	こうかい	공개	
抗議	こうぎ	항의	
合議	ごうぎ	합의	
恒久	こうきゅう	"항구, 영구"	
号泣	ごうきゅう	"소리를 높여서 욺, 통곡"	
皇居	こうきょ	황거(천황의 거처)	
好況	こうきょう	"호황, 호경기"	
鉱業	こうぎょう	광업	
興業	こうぎょう	흥업(새로이 사업을 일으킴)	
貢献	こうけん	공헌	
高原	こうげん	고원	
耕作	こうさく	경작	
工作	こうさく	"공작, 만듦"	
講習	こうしゅう	강습	
口述	こうじゅつ	구술	
控除	こうじょ	공제	
交渉	こうしょう	교섭	
更新	こうしん	갱신	
行進	こうしん	행진	
攻勢	こうせい	공세	
合成	ごうせい	합성	
公然	こうぜん	공공연함	
構想	こうそう	구상	
抗争	こうそう	항쟁	
拘束	こうそく	구속	
後退	こうたい	후퇴	
光沢	こうたく	광택	
豪邸	ごうてい	호화저택	
口頭	こうとう	"구두, 입으로 말함"	
講読	こうどく	강독	
購読	こうどく	구독	
荒廃	こうはい	황폐	
購買	こうばい	구매	
好評	こうひょう	호평	
降伏	こうふく	항복	
候補	こうほ	후보	
公募	こうぼ	공모	
傲慢	ごうまん	"오만함, 거만함"	
行楽	こうらく	행락	
効率	こうりつ	효율	
考慮	こうりょ	고려	
護衛	ごえい	호위	
互角	ごかく	"호각, 막상막하"	
顧客	こきゃく	고객	
極意	ごくい	"비법, (예도 · 무술의) 가장 심오한 경지"	
告訴	こくそ	고소	
告知	こくち	"고지, 알림, 통지"	
酷評	こくひょう	혹평	
国防	こくぼう	국방	
国有	こくゆう	"국유, 국가 소유"	
極楽	ごくらく	극락	
国連	こくれん	"국제연합, 유엔"	
心地	ここち	"기분, 마음"	
誤差	ごさ	오차	
孤児	こじ	고아	
固辞	こじ	고사(굳이 사양함)	
誇示	こじ	과시	
固執	こしつ	고집	
故障	こしょう	고장	
戸籍	こせき	호적	
骨子	こっし	"골자, 요점"	
事柄	ことがら	"사항, 일, 사물의 형편, 사정"	
孤独	こどく	고독	
粉々	こなごな	"산산이 부서짐, 산산조각"	
小幅	こはば	소폭	
碁盤	ごばん	바둑판	
古墳	こふん	고분	
雇用	こよう	고용	
古来	こらい	"고래, 예로부터"	
根幹	こんかん	근간	
懇願	こんがん	간원(간절히 원함)	
混血	こんけつ	혼혈	
根源	こんげつ	근원	
混雑	こんがつ	혼잡	
昏睡	こんすい	혼수(상태)	
昆虫	こんちゅう	곤충	
根底	こんてい	"근저, 밑바탕, 기초"	
混同	こんどう	혼동	
根本	こんぽん	근본	
混迷	こんめい	혼미	
混乱	こんらん	혼란	
災害	さいがい	재해	
才覚	さいかく	"재치, 기지"	
細菌	さいきん	세균	
細工	さいく	세공	
採掘	さいくつ	채굴	
採決	さいけつ	채결	
歳月	さいげつ	세월	
再建	さいけん	재건	
再現	さいげん	재현	
財源	ざいげん	재원	
採算	さいさん	채산	
財産	ざいさん	재산	
採取	さいしゅ	채취	
採集	さいしゅう	채집	
在職	ざいしょく	재직	
財政	ざいせい	재정	
在籍	ざいせき	"재적, 재학"	
採択	さいたく	채택	
栽培	さいばい	재배	
財布	さいふ	지갑	
細胞	さいぼう	세포	
催眠	さいみん	최면	
最良	さいりょう	"최선, 가장 좋음"	
裁量	さいりょう	재량	
差額	さがく	차액	
詐欺	さぎ	사기	
錯誤	さくご	착오	
作戦	さくせん	작전	
策略	さくりゃく	책략	
挫折	ざせつ	좌절	
雑貨	ざっか	잡화	
昨今	さっこん	"작금, 요즘"	
冊子	さっし	책자	
雑誌	ざっし	잡지	
刷新	さっしん	쇄신	
殺人	さつじん	살인	
殺到	さっとう	"쇄도, 밀려듦"	
座標	ざひょう	좌표	
作用	さよう	작용	
酸化	さんか	산화	
参画	さんかく	참획(계획에 참여함)	
山岳	さんがく	산악	
参観	さんかん	참관	
残金	ざんきん	잔금	
惨事	さんじ	참사	
産出	さんしゅつ	산출	
参照	さんしょう	참조	
残高	ざんだか	"잔고, 잔액"	
惨敗	ざんぱい・さんぱい	참패	
桟橋	さんばし	"선창, 부두"	
産物	さんぶつ	산물	
山脈	さんみゃく	산맥	
飼育	しいく	사육	
自営	じえい	자영	
歯科	しか	치과	
自我	じが	자아	
視覚	しかく	시각	
時期	じき	시기	
磁器	じき	자기(도자기)	
磁気	じき	자기(자석이 갖는 작용 · 성질)	
色彩	しきさい	"① 색채 ② 특색, 경향"	
資金	しきん	자금	
資源	しげん	자원	
思考	しこう	"사고, 생각"	
施工	しこう・せこう	시공	
施行	しこう	"시행, 실시"	
試行	しこう	시행(시험삼아 행함)	
志向	しこう	지향	
嗜好	しこう	기호	
時効	じこう	(공소)시효	
至極	しごく	"지극, 더없음, 극히"	
地獄	じごく	지옥	
示唆	しさ	시사	
時差	じさ	시차	
思索	しさく	사색	
資産	しさん	자산	
自首	じしゅ	자수	
自主	じしゅ	자주	
死傷	ししょう	사상(자)	
師匠	ししょう	"선생, 스승"	
辞職	じしょく	사직	
姿勢	しせい	자세	
視線	しせん	시선	
子息	しそく	자식	
持続	じぞく	지속	
子孫	しそん	자손	
事態	じたい	사태	
辞退	じたい	사퇴	
下心	したごころ	"본심, 저의, 속셈, 음모"	
下地	したじ	"준비, 기초, 소질"	
下火	したび	"불기운이 약해짐, 한고비 지남"	
実家	じっか	"생가, 친정"	
失格	しっかく	실격	
疾患	しっかん	질환	
質疑	しつぎ	질의	
失脚	しっきゃく	실각	
実況	じっきょう	실황	
実刑	じっけい	실형	
失言	しつげん	실언	
実権	じっけん	실권	
執行	しっこう	집행	
実在	じつざい	실재	
実質	じっしつ	실질	
𠮟責	しっせき	질책	
実践	じっせん	실천	
実態	じったい	실태	
失調	しっちょう	조화를 잃음	
師弟	してい	사제	
指摘	してき	지적	
老舗	しにせ	"노포, 오래된 점포"	
自腹	じばら	"자기 배, 자기 돈"	
自負	じふ	자부	
司法	しほう	사법	
志望	しぼう	지망	
脂肪	しぼう	지방	
始末	しまつ	"전말, 꼴, 모양"	
使命	しめい	사명	
指紋	しもん	지문	
釈然	しゃくぜん	석연(의혹이나 꺼림칙한 마음이 없음)	
視野	しや	시야	
社交	しゃこう	사교	
謝罪	しゃざい	사죄	
射殺	しゃさつ	사살	
謝辞	しゃじ	감사(사과)의 말	
謝絶	しゃぜつ	사절	
若干	じゃっかん	"약간, 어느 정도"	
邪魔	じゃま	방해	
砂利	じゃり	자갈	
車両	しゃりょう	차량	
収穫	しゅうかく	수확	
修学	しゅうがく	수학	
周期	しゅうき	주기	
就業	しゅうぎょう	취업	
襲撃	しゅうげき	습격	
秀作	しゅうさく	"수작, 걸작"	
修士	しゅうし	석사	
収支	しゅうし	수지	
重視	じゅうし	중시	
収縮	しゅうしゅく	수축	
重傷	じゅうしょう	중상	
就職	しゅうしょく	취직	
修飾	しゅうしょく	수식	
十全	じゅうぜん	만전(아주 완전함)	
終息	しゅうそく	종식	
従属	じゅうぞく	종속	
拾得	しゅうとく	습득	
就任	しゅうにん	취임	
従来	じゅうらい	종래	
修了	しゅうりょう	수료	
収録	しゅうろく	수록	
守衛	しゅえい	수위	
受給	じゅきゅう	수급(급여나 배급을 받음)	
需給	じゅきゅう	수급(수요와 공급)	
祝賀	しゅくが	축하	
淑女	しゅくじょ	숙녀	
縮小	しょくしょう	축소	
宿命	しゅくめい	숙명	
熟慮	じゅくりょ	"숙려, 숙고"	
熟練	じゅくれん	숙련	
手芸	しゅげい	수예	
主権	しゅけん	주권	
主催	しゅさい	주최	
種子	しゅし	종자	
主軸	しゅじく	주축	
主唱	しゅしょう	주창	
首相	しゅしょう	수상	
守勢	しゅせい	수세	
出帆	しゅっぱん	출범	
守備	しゅび	수비	
手法	しゅほう	수법	
授与	じゅよ	수여	
需要	じゅよう	수요	
受理	じゅり	수리(문서를 받아서 처리)	
樹立	じゅりつ	수립	
順境	じゅんきょう	순조로운 환경	
生涯	しょうがい	"생애, 평생"	
消去	しょうきょ	소거	
証言	しょうげん	증언	
小康	しょうこう	"소강, 조금 안정됨"	
照合	しょうごう	대조(하여 확인함)	
賞賛	しょうさん	칭찬	
焼死	しょうし	"소사, 타 죽음"	
上質	じょうしつ	"상질, 질이 좋음"	
成就	じょうじゅ	성취	
詳述	しょうじゅつ	"상술, 자세하게 진술함"	
症状	しょうじょう	증상	
精進	しょうじん	"정진, 전념"	
焦燥	しょうそう	초조	
消息	しょうそく	소식	
正体	しょうたい	정체	
証人	しょうにん	증인	
商売	しょうばい	장사	
譲歩	じょうほ	양보	
照明	しょうめい	조명	
消滅	しょうめつ	소멸	
上陸	じょうりく	상륙	
蒸留	じょうりゅう	증류	
除外	じょがい	제외	
所行・所業	しょぎょう	(나쁜) 소행	
職務	しょくむ	직무	
徐行	じょこう	서행	
所作	しょさ	"행위, 소행, 태도"	
所持	しょじ	소지	
触覚	しょっかく	촉각	
所定	しょてい	소정(정한 바)	
処罰	しょばつ	처벌	
書評	しょひょう	서평	
処分	しょぶん	처분	
庶民	しょみん	서민	
庶務	しょむ	서무	
書面	しょめん	서면	
時流	じりゅう	"시류, 그 시대의 경향"	
飼料	しりょう	사료	
視力	しりょく	시력	
指令	しれい	지령	
素人	しろうと	"풋내기, 아마추어"	
師走	しわす	"섣달, 음력 12월"	
進化	しんか	진화	
侵害	しんがい	침해	
新規	しんき	신규	
審議	しんぎ	심의	
心境	しんきょう	심경	
辛苦	しんく	쓰라린 고생	
神経	しんけい	신경	
進撃	しんげき	진격	
進行	しんこう	진행	
信仰	しんこう	신앙	
新興	しんこう	신흥	
進攻	しんこう	"진공, 진격"	
振興	しんこう	진흥	
親交	しんこう	친교	
侵攻	しんこう	침공	
新婚	しんこん	신혼	
審査	しんさ	심사	
震災	しんさ	"진재, 지진으로 인한 재해"	
紳士	しんし	신사	
真実	しんじつ	진실	
心中	しんじゅう	동반 자살	
伸縮	しんしゅく	신축(늘이고 줄임)	
心情	しんじょう	심정	
浸食	しんしょく	침식	
申請	しんせい	신청	
神聖	しんせい	신성	
真相	しんそう	진상	
陣地	じんち	진지	
新築	しんちく	신축(새로 지음)	
進展	しんてん	진전	
神殿	しんでん	"신전, 신사의 본전"	
振動	しんどう	진동	
信任	しんにん	신임	
信念	しんねん	신념	
神秘	しんぴ	신비	
新薬	しんやく	신약	
真理	しんり	진리	
侵略	しんりゃく	침략	
診療	しんりょう	진료	
進路	しんろ	진로	
素足	すあし	맨발	
水準	すいじゅん	수준	
随所	ずいしょ	"도처, 여기저기, 곳곳"	
推奨	すいしょう	"추장, 권함"	
推進	すいしん	추진	
水洗	すいせん	수세	
吹奏	すいそう	취주(입으로 불어서 연주함)	
衰退	すいたい	쇠퇴	
水田	すいでん	"수전, 논"	
出納	すいとう	출납	
水泡	すいほう	"수포, 물거품"	
崇拝	すうはい	숭배	
素手	すで	"맨손, 빈속"	
生育	せいいく	"(식물의) 생육, 자라서 커짐"	
成育	せいいく	"(동물의) 성육, 자람"	
精鋭	せいえい	정예	
西欧	せいおう	서구	
正規	せいき	정규	
正義	せいぎ	정의	
政局	せいきょく	정국	
政権	せいけん	정권	
制限	せいげん	제한	
制裁	せいさい	제재	
精算	せいさん	정산	
静止	せいし	정지(멈추어 움직이지 않음)	
静寂	せいじゃく	정적	
整然	せいぜん	정연(가지런하게 정돈되어 있음)	
盛装	せいそう	성장(옷을 화려하게 차려 입음)	
清濁	せいだく	청탁(맑음과 흐림)	
制定	せいてい	제정	
静的	せいてき	정적	
製鉄	せいてつ	제철	
精度	せいど	"정도, 정밀도"	
整頓	せいとん	정돈	
征服	せいふく	정복	
精密	せいみつ	정밀	
税務	ぜいむ	세무	
整列	せいれつ	정렬	
責務	せきむ	책무	
赤面	せきめん	얼굴을 붉힘	
施工	せこう・しこう	시공	
是正	ぜせい	시정(그릇된 것을 바로잡음)	
絶賛	ぜっさん	"절찬, 극찬"	
設置	せっち	설치	
折衷	せっちゅう	절충	
窃盗	せっとう	절도	
折半	せっぱん	"절반, 반분함"	
絶版	ぜっぱん	절판	
絶望	ぜつぼう	절망	
是非	ぜひ	"시비, 옳고 그름"	
世論	せろん・よろん	여론	
繊維	せんい	섬유	
全快	ぜんかい	"전쾌, 완쾌"	
旋回	せんかい	선회	
宣教	せんきょう	선교	
宣言	せんげん	선언	
戦災	せんさい	전재(전쟁으로 인한 재해)	
専修	せんしゅう	"전수, 전공"	
戦術	せんじゅつ	전술	
善処	ぜんしょ	선처	
潜水	せんすい	잠수	
宣誓	せんせい	선서	
全盛	ぜんせい	전성(기)	
前提	ぜんてい	전제	
前途	ぜんと	"전도, 앞길"	
銭湯	せんとう	공중 목욕탕	
戦闘	せんとう	전투	
先導	せんどう	선도	
潜入	せんにゅう	잠입	
専念	せんねん	전념	
船舶	せんぱく	선박	
羨望	せんぼう	선망	
全滅	ぜんめつ	전멸	
専用	せんよう	전용	
旋律	せんりつ	선율	
占領	せんりょう	점령	
善良	ぜんりょう	선량	
先例	せんれい	"선례, 전례"	
前例	ぜんれい	전례	
洗練	せんれん	세련	
総会	そうかい	총회	
創刊	そうかん	창간	
臓器	ぞうき	장기	
雑木	ぞうき	잡목	
増強	ぞうきょう	증강	
創建	そうけん	창건	
相互	そうご	상호	
総合	そうごう	종합	
捜査	そうさ	수사	
捜索	そうさく	수색	
喪失	そうしつ	상실	
操縦	そうじゅう	조종	
瘦身	そうしん	"수신, 야윈 몸"	
増進	ぞうしん	증진	
創造	そうぞう	창조	
相対	そうたい	상대	
争奪	そうだつ	쟁탈	
装着	そうちゃく	창작	
想定	そうてい	상정	
贈呈	ぞうてい	증정	
騒動	そうどう	소동	
遭難	そうなん	조난	
装備	そうび	장비	
双璧	そうへき	쌍벽	
創立	そうりつ	창립	
阻害	そがい	저해	
即死	そくし	즉사	
促進	そくしん	촉진	
即席	そくせき	즉석	
測定	そくてい	측정	
束縛	そくばく	속박	
狙撃	そげき	저격	
組織	そしき	조직	
素質	そしつ	소질	
蘇生	そせい	"소생, 되살아남"	
疎通	そつう	소통	
即刻	そっこく	"즉각, 곧"	
率先	そっせん	솔선	
尊厳	そんげん	존엄	
存続	そんぞく	존속	
退化	たいか	퇴화	
退却	たいきゃく	"퇴각, 후퇴"	
耐久	たいきゅう	"내구, 오래 견딤"	
体現	たいげん	"체현, 구현"	
退治	たいじ	퇴치	
大衆	たいしゅう	대중	
対処	たいしょ	대처	
態勢	たいせい	태세	
大勢	たいせい	대세	
対戦	たいせん	대전	
対談	たいだん	대담(서로 이야기를 주고 받음)	
台帳	だいちょう	"대장, 장부"	
台頭	たいとう	대두(세력을 뻗음)	
滞納	たいのう	체납	
代弁	だいべん	대변	
待望	たいぼう	대망	
怠慢	たいまん	태만	
貸与	たいよ	대여	
楕円	だえん	타원	
達筆	たっぴつ	달필(글씨나 문장을 잘 씀)	
打撃	だげき	타격	
妥結	だけつ	타결	
駄作	ださく	졸작	
打診	だしん	"타진, (상대방을) 떠봄, 알아봄"	
脱出	だっしゅつ	탈출	
達人	たつじん	달인	
脱税	だつぜい	탈세	
多発	たはつ	"다발, 많이 발생함"	
担架	たんか	들것	
段階	だんかい	단계	
嘆願	たんがん	탄원	
弾丸	だんがん	탄환	
探求	たんきゅう	탐구	
団結	だんけつ	단결	
探検	たんけん	탐험	
短縮	たんしゅく	단축	
断絶	だんぜつ	단절	
炭素	たんそ	탄소	
探知	たんち	탐지	
断念	だんねん	단념	
短波	たんぱ	단파	
談判	だんぱん	담판	
断面	だんめん	단면	
弾力	だんりょく	탄력	
鍛錬	たんれん	"단련, 연마"	
談話	だんわ	담화	
知己	ちき	"지기, 지인"	
畜産	ちくさん	축산	
蓄積	ちくせき	축적	
秩序	ちつじょ	질서	
窒息	ちっそく	질식	
着実	ちゃくじつ	착실	
着手	ちゃくしゅ	착수	
着色	ちゃくしょく	착색	
着目	ちゃくもく	"착목, 주목, 착안"	
着工	ちゃっこう	착공	
仲裁	ちゅうさい	중재	
抽出	ちゅうしゅつ	추출	
中傷	ちゅうしょう	중상	
中和	ちゅうわ	중화	
調印	ちょういん	조인	
聴覚	ちょうかく	청각	
兆候	ちょうこう	"징후, 조짐"	
聴講	ちょうこう	청강	
彫刻	ちょうこく	조각	
調停	ちょうてい	"조정, 중재"	
重複	ちょうふく・じゅうふく	중복	
貯金	ちょきん	저금	
著述	ちょじゅつ	저술	
著書	ちょしょ	저서	
貯蓄	ちょちく	저축	
賃金	ちんぎん	임금	
沈殿	ちんでん	침전(밑바닥에 가라앉음)	
沈没	ちんぼつ	침몰	
追憶	ついおく	추억	
追求	ついきゅう	추구	
追跡	ついせき	추적	
追放	ついほう	추방	
墜落	ついらく	추락	
痛感	つうかん	통감	
津波	つなみ	해일	
提案	ていあん	제안	
定義	ていぎ	정의	
提供	ていきょう	제공	
提携	ていけい	제휴	
体裁	ていさい	"① 외관, 겉모양 ② 체면"	
停止	ていし	정지(하던 일을 중도에 멈춤)	
呈示	ていじ	"꺼내 보임, 제시"	
提示	ていじ	제시	
提唱	ていしょう	제창	
停滞	ていたい	(자금 · 경기 · 업무 등의) 정체	
低調	ていちょう	저조	
堤防	ていぼう	"제방, 둑"	
定理	ていり	(수학 · 공식 등의) 정리	
適応	てきおう	적응	
適宜	てきぎ	적당함	
摘出	てきしゅつ	"적출, 집어냄, 들추어 냄"	
適性	てきせい	적성	
摘発	てきはつ	적발	
手際	てぎわ	"솜씨, 수완"	
手口	てぐち	(범죄) 수법	
手錠	てじょう	수갑	
手数	てすう	수고	
撤回	てっかい	철회	
撤去	てっきょ	철거	
鉄鋼	てっこう	철강	
撤収	てっしゅう	철수	
鉄則	てっそく	철칙	
撤退	てったい	"철퇴, 철수"	
鉄棒	てつぼう	철봉	
転嫁	てんか	"전가, 떠넘김"	
転換	てんかん	전환	
伝言	でんごん	전언	
添削	てんさく	첨삭	
伝説	でんせつ	전설	
伝達	でんたつ	전달	
転任	てんにん	전임	
天罰	てんばつ	천벌	
転覆	てんぷく	전복	
店舗	てんぽ	점포	
展望	てんぼう	전망	
伝来	でんらい	전래	
転落	てんらく	전락	
投機	とうき	투기	
討議	とうぎ	토의	
動機	どうき	동기	
同居	どうきょ	동거	
陶芸	とうげい	도자기 공예	
投稿	とうこう	투고	
投合	とうごう	"투합, (마음 따위가) 서로 딱 맞음"	
動向	どうこう	동향	
投資	とうし	투자	
同士	どうし	"한패, ~끼리"	
同志	どうし	동지	
同情	どうじょう	동정	
統制	とうせい	통제	
銅像	どうぞう	동상	
統率	とうそつ	통솔	
到達	とうたつ	도달	
統治	とうち	통치	
登頂	とうちょう	등정(산 꼭대기에 올라감)	
同調	どうちょう	동조	
同等	どうとう	동등	
投入	とうにゅう	투입	
同封	どうふう	동봉	
答弁	とうべん	답변	
動揺	どうよう	동요	
登録	とうろく	등록	
度胸	どきょう	"담력, 배짱"	
得策	とくさく	상책	
特集	とくしゅう	특집	
独奏	どくそう	독주	
独創	どくそう	독창	
独断	どくだん	독단	
特派	とくは	특파	
匿名	とくめい	익명	
途上	とじょう	"도상, 도중"	
特許	とっきょ	특허	
特権	とっけん	특권	
突端	とったん	쑥 내민 끝	
突破	とっぱ	돌파	
土手	どて	"둑, 제방"	
殿様	とのさま	"나리, 영주님"	
土俵	どひょう	씨름판	
途方	とほう	"① 수단, 방도 ② 조리, 도리"	
渡来	とらい	도래	
鳥肌	とりはだ	소름	
取引	とりひき	거래	
奴隷	どれい	노예	
徒労	とろう	헛수고	
泥沼	どろぬま	"수렁, 진창"	
内蔵	ないぞう	내장(내부에 가지고 있음)	
内乱	ないらん	내란	
仲人	なこうど	중매(인)	
名残	なごり	"여운, 흔적"	
雪崩	なだれ	눈사태	
生身	なまみ	"날고기, 생고기"	
奈落	ならく	"나락, 밑바닥"	
任意	にんい	임의	
認識	にんしき	인식	
人情	にんじょう	인정	
妊娠	にんしん	임신	
任務	にんむ	임무	
音色	ねいろ	음색	
熱意	ねつい	열의	
熱湯	ねっとう	"열탕, 뜨거운 물"	
熱量	ねつりょう	열량	
粘液	ねんえき	점액	
年賀	ねんが	"연하, 신년 축하"	
年鑑	ねんかん	연감	
捻出	ねんしゅつ	"염출, 각출"	
燃焼	ねんしょう	연소	
年配	ねんぱい	"① 연배, 나이 또래 ② 중년"	
念仏	ねんぶつ	염불	
燃料	ねんりょう	연료	
年輪	ねんりん	연륜	
農耕	のうこう	농경	
濃縮	のうしゅく	농축	
把握	はあく	파악	
排気	はいき	배기	
廃棄	はいき	폐기	
配給	はいきゅう	배급	
背景	はいけい	배경	
背後	はいご	배후	
拝借	はいしゃく	삼가 빌려 씀	
排出	はいしゅつ	"배출, 배설"	
輩出	はいしゅつ	배출(인재가 연달아 많이 나옴)	
排除	はいじょ	배제	
賠償	ばいしょう	배상(손해를 물어줌)	
配信	はいしん	(정보 · 데이터 등의) 전송	
排水	はいすい	배수	
廃水	はいすい	폐수	
排斥	はいせき	배척	
敗戦	はいせん	패전	
背任	はいにん	배임(임무를 저버림)	
敗北	はいぼく	패배	
培養	ばいよう	배양	
倍率	ばいりつ	배율	
配慮	はいりょ	배려	
破壊	はかい	파괴	
波及	はきゅう	파급	
迫害	はくがい	박해	
爆撃	ばくげき	폭격	
薄弱	はくじゃく	"박약, 빈약"	
白状	はくじょう	자백	
剝奪	はくだつ	박탈	
爆弾	ばくだん	폭탄	
爆破	ばくは	폭파	
派遣	はけん	파견	
破綻	はたん	파탄	
蜂蜜	はちみつ	"봉밀, 벌꿀, 꿀"	
発育	はついく	발육	
発芽	はつが	발아	
発覚	はっかく	발각	
発掘	はっくつ	발굴	
発現	はつげん	발현	
伐採	ばっさい	벌채	
発注	はっちゅう	발주	
発熱	はつねつ	발열	
発病	はつびょう	발병	
発泡	はっぽう	발포(거품이 일어남)	
発砲	はっぽう	발포(총포를 쏨)	
破裂	はれつ	파열	
繫栄	はんえい	번영	
反感	はんかん	반감	
反響	はんきょう	반항	
反撃	はんげき	반격	
判決	はんけつ	판결	
犯罪	はんざい	범죄	
反射	はんしゃ	반사	
万障	ばんしょう	만사	
判然	はんぜん	"판연, 명백함"	
万端	ばんたん	"만반, 모든 사항이나 수단"	
範疇	はんちゅう	"범주, 카테고리"	
判定	はんてい	판정	
万人	ばんにん	만인	
晩年	ばんねん	"만년, 노년"	
反応	はんのう	반응	
万能	ばんのう	만능	
反乱	はんらん	반란	
氾濫	はんらん	범람	
被害	ひがい	피해	
日陰	ひかげ	"응달, 그늘"	
悲観	ひかん	비관	
否決	ひけつ	부결	
秘訣	ひけつ	비결	
非行	ひこう	비행(도덕에 어긋난 행위)	
比重	ひじゅう	비중	
微笑	びしょう	미소	
皮相	ひそう	"피상, 거죽, 표면"	
秘蔵	ひぞう	비장	
備蓄	びちく	비축	
必修	ひっす・ひっしゅう	필수	
必然	ひつぜん	필연	
匹敵	ひってき	필적	
一頃	ひところ	"한때, 한동안, 왕년"	
一筋	ひとすじ	"한줄기, 외곬, 일편단심"	
人波	ひとなみ	"인파, 사람의 물결"	
人目	ひとめ	남의 눈	
一目	ひとめ	"한 번(만) 봄, 한눈(에 들어오는 모양)"	
皮肉	ひにく	"빈정거림, 비꼼, 야유"	
火花	ひばな	"불꽃, 불똥, 불티"	
美貌	びぼう	미모	
悲鳴	ひめい	비명	
罷免	ひめん	파면	
飛躍	ひやく	비약	
描写	びょうしゃ	모샤	
表彰	ひょうしょう	표창	
病状	びょうじょう	"병상, 병세"	
評判	ひょうばん	"평판, 인기가 있음"	
肥沃	ひよく	비옥함	
比率	ひりつ	비율	
肥料	ひりょう	비료	
微量	びりょう	"미량, 극소량"	
秘話	ひわ	비화	
貧血	ひんけつ	빈혈	
貧困	ひんこん	빈곤	
便乗	びんじょう	편승	
頻度	ひんど	빈도	
貧乏	びんぼう	"빈공, 가난"	
封鎖	ふうさ	봉쇄	
風俗	ふうぞく	풍속	
負荷	ふか	"부하, 짐을(임무를) 짐"	
不吉	ふきつ	불길	
普及	ふきゅう	보급	
不朽	ふきゅう	"불후, 불멸"	
布教	ふきょう	"포교, 전도"	
複合	ふくごう	복합	
複写	ふくしゃ	복사	
服従	ふくじゅう	복종	
服装	ふくそう	복장	
覆面	ふくめん	복면	
福利	ふくり	"복리, 복지"	
富豪	ふごう	"부호, 갑부"	
布告	ふこく	(전쟁의 선전)포고	
負債	ふさい	부채	
腐食	ふしょく	부식	
不振	ふしん	부진	
武装	ぶそう	무장	
不遜	ふそん	"불손, 무례"	
負担	ふたん	부담	
不断	ふだん	"부단함, 끊임없음"	
復活	ふっかつ	부활	
物議	ぶつぎ	물의	
物質	ぶっし	물자	
払拭	ふっしょく	불식	
物色	ぶっしょく	물색	
仏像	ぶつぞう	불상	
物体	ぶったい	물체	
沸騰	ふっとう	"비등, 끓어오름"	
腐敗	ふはい	부패	
不評	ふひょう	불평	
訃報	ふほう	부고	
扶養	ふよう	부양	
不慮	ふりょ	"의외, 뜻밖"	
浮力	ふりょく	부력	
武力	ぶりょく	무력	
噴火	ふんか	분화	
憤慨	ふんがい	분개	
奮起	ふんき	"분기, 분발"	
分業	ぶんぎょう	분업	
憤激	ふんげき	격분	
粉砕	ふんさい	분쇄	
分際	ぶんざい	"분수, 주제"	
分散	ぶんさん	분산	
紛失	ふんしつ	분실	
噴射	ふんしゃ	분사	
噴出	ふんしゅつ	분출	
紛争	ふんそう	분쟁	
分担	ぶんたん	분담	
文通	ぶんつう	편지 왕래	
奮闘	ふんとう	분투	
粉末	ふんまつ	분말	
分離	ぶんり	분리	
分裂	ぶんれつ	분열	
兵器	へいき	"병기, 무기"	
閉業	へいぎょう	폐업	
並行	へいこう	병행	
閉口	へいこう	"질림, 손듦, 질색, 항복함"	
米穀	べいこく	"미곡, 곡물"	
平常	へいじょう	"평상, 평소, 보통"	
閉幕	へいまく	폐막	
並列	へいれつ	"병렬, 줄을 지음"	
別途	べっと	별도(로)	
変革	へんかく	변혁	
返還	へんかん	반환	
偏見	へんけん	편견	
弁護	べんご	변호	
弁償	べんしょう	변상	
弁舌	べんぜつ	"변설, 언변"	
変遷	へんせん	변천	
変動	へんどう	변동	
変貌	へんぼう	변모	
変容	へんよう	변용	
弁論	べんろん	변론	
保育	ほいく	보육	
方案	ほうあん	방안	
法案	ほうあん	법안	
防衛	ぼうえい	방위	
貿易	ぼうえき	무역	
崩壊	ほうかい	붕괴	
望外	ぼうがい	"망외, 기대한 이상임"	
放棄	ほうき	포기	
防御	ぼうぎょ	방어	
封建	ほうけん	봉건	
冒険	ぼうけん	모험	
方策	ほうさく	방책	
豊作	ほうさく	풀작	
報酬	ほうしゅう	보수	
放出	ほうしゅつ	방출	
紡績	ぼうせき	방적	
放置	ほうち	방치	
傍聴	ぼうちょう	방청	
膨張	ぼうちょう	팽창	
法定	ほうてい	법정	
報道	ほうどう	보도	
冒頭	ぼうとう	"모두, 서두"	
暴動	ぼうどう	폭동	
冒涜	ぼうとく	모독	
放任	ほうにん	방임	
褒美	ほうび	포상	
抱負	ほうふ	포부	
暴風	ぼうふう	폭풍	
暴落	ぼうらく	폭락	
暴力	ぼうりょく	폭력	
保温	ほおん	보온	
捕獲	ほかく	포획	
保管	ほかん	보관	
補給	ほきゅう	보급	
補強	ほきょう	보강	
募金	ぼきん	모근	
撲滅	ぼくめつ	박멸	
捕鯨	ほげい	"포경, 고래잡이"	
保持	ほじ	유지	
保障	ほしょう	보장	
補償	ほしょう	보상	
舗装	ほそう	포장	
勃起	ぼっき	"발기, 갑자기 일어남"	
勃興	ぼっこう	"발흥, 진흥"	
発作	ほっさ	발작	
没収	ぼっしゅう	몰수	
発足	ほっそく	발족	
発端	ほったん	"발단, 시초"	
勃発	ぼっぱつ	발발	
没落	ぼつらく	몰락	
保養	ほよう	보양	
捕虜	ほりょ	포로	
本能	ほんのう	본능	
本末	ほんまつ	본말	
本望	ほんもう	"본망, 숙원"	
翻弄	ほんろう	"본롱, 농락"	
本論	ほんろん	본론	
埋設	まいせつ	매설	
埋蔵	まいぞう	매장	
埋没	まいぼつ	매몰	
真上	まうえ	바로 위	
真心	まごころ	"진심, 정성"	
真下	ました	"바로 밑, 바로 아래"	
麻酔	ますい	마취	
街角	まちかど	길모퉁이	
抹消	まっしょう	말소	
末梢	まっしょう	"말초, 맨끝"	
末端	まったん	말단	
麻痺	まひ	마비	
満場	まんじょう	만장	
慢性	まんせい	만성	
身内	みうち	"온 몸, 전신, 집안"	
味覚	みかく	미각	
身柄	みがら	"신분, 신병"	
水気	みずけ	"수분, 물기"	
未然	みぜん	미연	
道端	みちばた	"길의 주변, 길가"	
密度	みつど	밀도	
妙案	みょうあん	묘안	
民衆	みんしゅう	민중	
無縁	むえん	"무연고, 관계가 없음"	
無効	むこう	무효	
無断	むだん	무단	
無念	むねん	무념	
迷信	めいしん	미신	
命中	めいちゅう	명중	
名簿	めうぼ	명부	
目方	めかた	"무게, 중량"	
目線	めせん	"눈길, 시선"	
滅亡	めつぼう	멸망	
免疫	めんえき	면역	
免職	めんしょく	면직	
免責	めんせき	면책	
面倒	めんどう	"① 귀찮음 ② 돌봄, 보살핌"	
面目	めんぼく・めんもく	"면목, 체면"	
猛暑	もうしょ	"혹서, 심한 더위"	
妄想	もうそう	망상	
盲点	もうてん	맹점	
目撃	もくげき	목격	
黙認	もくにん	묵인	
模索	もさく	모색	
物事	ものごと	"세상사, 매사"	
喪服	もふく	상복	
模倣	もほう	모방	
模様	もよう	"모양, 무늬"	
役柄	やくがら	"직무의 성질, 직책이 있는 신분"	
役職	やくしょく	"직무, 관리직"	
躍進	やくしん	약진	
役場	やくば	"지방 공무원이 사무를 보는 곳, (공증인 · 법무사의) 사무소"	
役割	やくわり	역할	
屋敷	やしき	"대지, 집의 부지, 저택"	
遺言	ゆいごん	유언	
優越	ゆうえつ	우월	
誘拐	ゆうかい	유괴	
有機	ゆうき	유기	
融合	ゆうごう	융합	
融資	ゆうし	융자	
有終	ゆうしゅう	"유종, 끝을 잘 맺음"	
優勢	ゆうせい	우세	
優先	ゆうせん	우선	
悠然	ゆうぜん	유연(침착하고 여유가 있는 모양)	
誘致	ゆうち	"유치, 불러들임"	
誘導	ゆうどう	유도	
誘発	ゆうはつ	유발	
優美	ゆうび	우아하고 아름다움	
郵便	ゆうびん	우편	
雄弁	ゆうべん	웅변	
遊牧	ゆうぼく	유목	
夕闇	ゆうやみ	"땅거미, 황혼"	
憂慮	ゆうりょ	우려	
融和	ゆうわ	융화	
夢路	ゆめじ	꿈길	
余韻	よいん	여운	
要因	よういん	요인	
溶液	ようえき	용액	
妖怪	ようかい	"요괴, 도깨비"	
養護	ようご	양호	
様式	ようしき	양식	
容赦	ようしゃ	용서	
養生	ようじょう	"보양, (건축) 파손 방지의 손질"	
養殖	ようしょく	양식	
要人	ようじん	요인	
要請	ようせい	요청	
養成	ようせい	양성	
様相	ようそう	양상	
洋風	ようふう	"서양풍, 서양식"	
要約	ようやく	요약	
余暇	よか	여가	
予感	よかん	예감	
余興	よきょう	여흥	
抑圧	よくあつ	억압	
欲望	よくぼう	욕망	
抑揚	よくよう	억양	
抑留	よくりゅう	억류	
予言	よげん	예언	
予告	よこく	예고	
横綱	よこづな	"씨름꾼의 최고위, 제1인자"	
予想	よそう	예상	
予測	よそく	예측	
余談	よだん	여담	
予兆	よちょう	"예조, 전조, 징조"	
欲求	よっきゅう	욕구	
輿論	よろん	여론	
弱音	よわね	"약한 말, 나약한 말"	
落胆	らくたん	낙담	
酪農	らくのう	낙농	
拉致	らち・らっち	납치	
濫用	らんよう	남용	
理屈	りくつ	"도리, 이치"	
利子	りし	이자	
利潤	りじゅん	이윤	
理性	りせい	이성	
利息	りそく	이자	
立脚	りっきゃく	입각	
利便	りべん	"편리, 편의"	
略奪	りゃくだつ	약탈	
留保	りゅうほ	"유보, 보류"	
領域	りょういき	영역	
領海	りょうかい	영해	
両極	りょうきょく	양극	
良質	りょうしつ	양질	
良識	りょうしき	양식	
領地	りょうち	영지	
領土	りょうど	영토	
旅券	りょけん	여권	
理論	りろん	이론	
輪郭	りんかく	윤곽	
林業	りんぎょう	임업	
臨終	りんじゅう	임종	
倫理	りんり	윤리	
類推	るいすい	유추	
冷蔵	れいぞう	냉장	
列挙	れっきょ	열거	
連係	れんけい	연계	
連結	れんけつ	연결	
連行	れんこう	연행	
連中	れんちゅう	"한 패, 동아리, 일당, 그 패들"	
連邦	れんぽう	연방	
連盟	れんめい	연맹	
朗読	ろうどく	낭독	
狼狽	ろうばい	"당황함, 허둥지둥함"	
浪費	ろうひ	낭비	
朗報	ろうほう	좋은 소식	
労務	ろうむ	노무	
労力	ろうりょく	"노력, 수고"	
録画	ろくが	녹화	
露出	ろしゅつ	노출	
露店	ろてん	노점	
論議	ろんぎ	논의	
論陣	ろんじん	논진	
惑星	わくせい	혹성	
枠内	わくない	"테두리 안, 범위 내"	
湾曲	わんきょく	활 모양으로 굽음	
腕力	わんりょく	"완력, (팔의) 힘"	
上がり	あがり	"끝남, (근무 · 일) 마침"	
頭打ち	あたまうち	한계점에 이름	
跡継ぎ	あとつぎ	"대를 이음, 후계자"	
あられ		싸락눈	
いびき		꼬고는 소리	
いんちき		"부정, 사기, 엉터리임"	
うたたね		"선잠, 얕은 잠"	
有頂天	うちょうてん	"기뻐서 어쩔 줄 모름, 기고만장"	
うなぎのぼり		빠르게 올라감	
うぬぼれ		자부(심)	
裏返し	うらがえし	뒤집음	
奥の手	おくのて	"오의, 비법"	
おすそ分け	おすそわけ	얻은 것의 일부를 남에게 나누어 줌	
おまけ		"값을 깎음, 덤, 경품"	
表向き	おもてむき	"공공연함, 표면상"	
かかと		발뒤꿈치	
駆け足	かけあし	"뛰어감, 구보"	
かすみ		안개(특히 봄안개를 이름)	
かたわら		"옆, 곁"	
画期的	かっきてき	획기적임	
金づち	かなづち	"쇠망치, 수영을 못하는 사람"	
花粉症	かふんしょう	꽃가루 알레르기	
体付き	からだつき	"몸매, 체격"	
かんがい		관개	
感無量	かんむりょう	감개무량	
貫ろく	かんろく	관록	
気兼ね	きがね	"어렵게 여김, 스스럼"	
気まぐれ	きまぐれ	변덕	
きまじめ		고지식함	
くじ		"제비, 추첨"	
くちばし		"부리, 주둥이"	
けだもの		짐승	
研さん	けんさん	"연찬, (학문 등을) 깊이 연구함"	
向学心	こうがくしん	향학열	
高齢化	こうれいか	고령화	
言づて	ことづて	"의탁, 전갈, 전언"	
差し引き	さしひき	"공제, 정산 결과"	
さなか		한창 ~인 때	
仕打ち	しうち	(남에 대한) 처사	
仕掛け	しかけ	"장치, 속임수"	
仕組み	しくみ	구조	
刺しゅう	ししゅう	자수	
しずく		물방울	
下調べ	したしらべ	"예비 조사, 예습"	
しつけ		예의 범절을 가르침	
下取り	したどり	신품의 대금 일부로 중고품을 판매자가 인수하는 일	
しにょう		대소변	
従業員	じゅうぎょういん	종업원	
終始一貫	しゅうしいっかん	시종일관	
正念場	しょうねんば	중요한 고비	
植民地	しょくみんち	식민지	
所持品	しょじひん	소지품	
ずぶぬれ		흠뻑 젖음	
擦れ違い	すれちがい	"마주 스쳐 지나감, 엇갈림"	
政府筋	せいふすじ	정부 소식통	
税務署	ぜいむしょ	세무서	
精力的	せいりょくてき	정력적임	
せがれ		"(자신의) 아들놈, 자식"	
そっぽ		"다른 쪽, 딴 쪽"	
そり		썰매	
そろい		(빠짐없이) 모두 갖추어짐	
たきび		모닥불	
たるみ		느슨함	
断トツ	ダントツ	단연 톱	
蛋白質	たんぱくしつ	단백질	
宙返り	ちゅうがえり	"공중제비, 공중회전"	
継ぎ目	つぎめ	"이음매, 이은 자리"	
つば		침	
つぼ		"단지, 항아리"	
つぼみ		꽃봉오리	
釣り鐘	つりがね	"조종, 범종"	
手がかり	てがかり	"단서, 실마리"	
できもの		"부스럼, 종기"	
手さばき	てさばき	손놀림	
手つかず	てつかず	"아직 손을 안 댐, 한 번도 쓰지 않음"	
手付き	てつき	"솜씨, 손놀림"	
手直し	てなおし	불완전한 곳을 고침	
出直し	でなおし	다시 함	
手の平	てのひら	손바닥	
伝統的	でんとうてき	전통적	
戸締まり	とじまり	문단속	
戸惑い	とまどい	"당황함, 허둥댐, 당혹함"	
共働き	ともばたらき	맞벌이	
共稼ぎ	ともかせぎ	맞벌이	
虎の巻	とらのまき	"병법의 비전서, 자습서"	
取り柄	とりえ	"취할 점, 쓸모, 장점"	
取り返し	とりかえし	"되찾음, 만회, 복원"	
取替えっこ	とりかえっこ	서로 바꿈	
取り崩し	とりくずし	"허는 일, 철거"	
とりこ		"사로잡힌 사람, 포로"	
取り調べ	とりしらべ	"조사, 수사, 문초, 신문"	
取り所	とりどころ	"취할 점, 장점"	
度忘れ	どわすれ	깜빡 잊어버림	
なぎさ		"물가, 둔치"	
何より	なにより	"최상, 제일"	
並大抵	なみたいてい	이만저만함	
にきび		여드름	
値打ち	ねうち	"가치, 값어치"	
ねばり		"찰기, 끈기"	
根回し	ねまわし	사전 교섭	
念入り	ねんいり	"조심스러움, 공들임"	
廃棄物	はいきぶつ	폐기물	
ばい菌	ばいきん	세균	
配偶者	はいぐうしゃ	배우자	
排せつ	はいせつ	배설	
橋渡し	はしわたし	"다리를 놓음, 가설, 중개, 중매"	
裸足	はだし	맨발	
発起人	ほっきにん	발기인	
抜てき	ばってき	발탁	
花びら	はなびら	꽃잎	
繫華街	はんかがい	번화가	
被害者	ひがいしゃ	피해자	
被疑者	ひぎしゃ	"피의자, 용의자"	
一角	ひとかど	"한 사람 몫, 제구실, 어엿함"	
人並み	ひとなみ	"보통 정도, 남과 같음"	
日取り	ひどり	"날짜를 정함, 기일, 일정"	
ひなた		"양지, 양달"	
披露宴	ひろうえん	피로연	
ピンはね		삥땅 침	
不可解	ふかかい	"불가해, 이해할 수 없음"	
不可欠	ふかけつ	불가결	
不祥事	ふしょうじ	불상사	
不条理	ふじょうり	부조리	
平行線	へいこうせん	평행선	
ほとり		"근처, 부근"	
前売り	まえうり	예매	
真っ二つ	まっぷたつ	"두 동강, 딱 절반"	
まばたき		깜박임	
丸ごと	まるごと	"통째(로), 온통"	
まり		"공, 볼"	
まんえん		만연	
真ん前	まんまえ	"바로 앞, 정면"	
見込み	みこみ	"전망, 예정"	
微じん	みじん	"미진, 작은 먼지"	
見積もり	みつもり	"어림, 견적"	
見通し	みとおし	"전망, 장래의 예측"	
身の上	みのうえ	"신상, 일신의 처지, 운명"	
見晴らし	みはらし	전망	
身振り	みぶり	몸짓	
無計画	むけいかく	무계획	
無条件	むじょうけん	무조건	
結び付き	むすびつき	"연결, 결합, 결속"	
無駄遣い	むだづかい	"낭비, 헛되이 씀"	
むら		얼룩	
目付き	めつき	"눈의 표정, 눈초리"	
めど		"목표, 전망"	
目盛り	めもり	(계량기의) 눈금	
もくろみ		"계획, 의도, 목적"	
持ち切り	もちきり	"그 상태나 화제가 계속됨, 자자함"	
やぶさか		인색함	
夕暮れ	ゆうぐれ	"황혼, 해질녘"	
夕焼け	ゆうやけ	저녁놀	
行き違い	ゆきちがい	"오해, 착오"	
ゆとり		여유	
容疑者	ようぎしゃ	용의자	
よしあし		"좋고 나쁨, 선악"	
よそみ		"한눈팖, 곁눈질"	
よだれ		"(흘리는) 침, 군침"	
夜更かし	よふかし	"밤 늦게까지 안 잠, 밤샘"	
夜更け	よふけ	"야밤, 심야"	
楽観的	らっかんてき	낙관적	
理性的	りせいてき	이성적	
臨機応変	りんきおうへん	임기응변	
倫理的	りんりてき	윤리적	
ろく		"사물의 상태가 정당함, 본격적임"	
渡り鳥	わたりどり	철새	
割り当て	わりあて	"할당, 배당"	
わんぱく		"장난꾸러기, 개구쟁이"	
仰ぐ	あおぐ	"쳐다보다, 우러러보다"	
赤らむ	あからむ	"붉어지다, 불그레해지다"	
商う	あきなう	장사하다	
飽きる	あきる	질리다	
欺く	あざむく	속이다	
あざわらう		"조소하다, 비웃다"	
あせる		바래다	
値する	あたいする	"~할 만하다, ~에 상당하다"	
あつらえる		"주문하다, 맞추다"	
暴く	あばく	"폭로하다, 파헤치다"	
甘える	あまえる	"응석부리다, 어리광부리다"	
余る	あまる	남다	
操る	あやつる	"조종하다, 다루다"	
あまりある		"남음이 있다, ~하는 데 충분하다"	
謝る	あやまる	사과하다	
荒らす	あらす	"망치다, 휩쓸다"	
争う	あらそう	다투다	
改まる	あらたまる	"새로워지다, 격식을 차리다"	
改める	あらためる	"고치다, 개선하다"	
著す	あらわす	저술하다	
合わす	あわす	합치다	
案じる・案ずる	あんじる・あんずる	"걱정하다, 염려하다"	
言い渡す	いいわたす	"(결정 · 명령 등) 알리다, 선고하다"	
生かす	いかす	살리다	
意気込む	いきごむ	"힘을 내다, 분발하다"	
生ける	いける	(꽃 등을) 꽃다	
炒める	いためる	"기름에 볶다, 지지다"	
痛める	いためる	"다치다, 손상하다"	
傷める	いためる	"망가뜨리다, 상하게 하다"	
慈しむ	いつくしむ	"불쌍히 여기다, 사랑하다"	
営む	いとなむ	"영위하다, 경영하다"	
否む	いなむ	"거절하다, 사절하다"	
いやす		(상처 · 병 따위를) 고치다	
いらだてる		"초조하게 하다, 애태우다"	
射る	いる	(활을) 쏘다	
浮かび上がる	うかびあがる	떠오르다	
受け入れる	うけいれる	받아들이다	
受け継ぐ	うけつぐ	"이어받다, 계승하다"	
受け止める	うけとめる	"받다, 받아들이다"	
薄まる	うすまる	엷어지다	
埋める	うずめる	"묻다, 매장하다"	
打ち切る	うちきる	"자르다, 중단하다"	
訴える	うったえる	"호소하다, 소송하다"	
疎んじる	うとんじる	"싫어하다, 멀리하다"	
潤む	うるむ	"(습기로) 부예지다, 울먹이다"	
植わる	うわる	심어지다	
演じる・演ずる	えんじる・えんずる	"① (무대에서) 연기하다 ② (어떤 역할을) 맡다, 완수하다"	
老いる	おいる	늙다	
負う	おう	"(힘)입다, 지다"	
侵す	おかす	"침범하다, 침해하다"	
冒す	おかす	무릅쓰다	
興る	おこる	"흥하다, 일어나다"	
抑える	おさえる	"억제하다, 막다"	
治まる	おさまる	"고요해지다, 가라앉다"	
納まる	おさまる	"걷히다, 들어오다"	
修める	おさめる	"닦다, 수양하다"	
押し切る	おしきる	"강행하다, 무릅쓰다"	
惜しむ	おしむ	"아끼다, 애석해하다"	
押し寄せる	おしよせる	"밀려 들다, 밀어 닥치다"	
推す	おす	"밀다, 추진시키다"	
恐れ入る	おそれいる	황송해하다	
おだてる		치켜세우다	
落ち合う	おちあう	"만나다, 합류하다"	
陥る	おちいる	"빠지다, 헤어나지 못하게 되다"	
おどす		"으르다, 위협하다"	
訪れる	おとずれる	"방문하다, (계절이) 찾아오다"	
衰える	おとろえる	"약해지다, 쇠퇴하다"	
驚く	おどろく	놀라다	
脅かす	おびやかす	"위협하다, 위태롭게 하다"	
赴く	おもむく	"향하여 가다, 즉시 향하다"	
折れる	おれる	"부러지다, 꺾이다"	
重んじる・重んずる	おもんじる・おもんずる	"중요시하다, 존중하다"	
下ろす	おろす	"내리다, (돈을) 찾다"	
害する	がいする	"해치다, 상하게 하다"	
回想する	かいそうする	회상하다	
顧みる	かえりみる	"돌아보다, 회고하다"	
省みる	かえりみる	"돌이켜보다, 반성하다"	
掲げる	かかげる	내걸다	
かき回す	かきまわす	휘젓다	
かく		(창피를) 당하다	
欠く	かく	"빠지다, 결여하다"	
駆けつける	かけつける	달려가다(오다)	
かける		"걸다, 내기를 하다"	
かさばる		부피가 커지다	
かさむ		부피가 커지다	
かすむ		"언개가 끼다, 희마하게 보이다"	
かする		스치다	
傾ける	かたむける	기울이다	
固める	かためる	"굳히다, 다지다"	
偏る	かたよる	치우치다	
奏でる	かなでる	연주하다	
適える	かなえる	① 들어맞추다 ② 충족시키다 ③ 성취시키다	
兼ねる	かねる	겸하다	
かばう		"감싸다, 비호하다"	
かぶれる		"(옻 등을) 차다, 피부염을 일으키다"	
構える	かまえる	"갖추다, 자세를 취하다"	
かまける		얽매이다	
かみ切る	かみきる	물어 끟다	
絡む	からむ	"얽히다, 얽매이다"	
枯れる	かれる	"(초목이) 마르다, 시들다"	
渇く	かわく	"목이 마르다, 물이 마르다"	
交わす	かわす	"주고받다, 교환하다"	
着飾る	きかざる	"몸치장을 하다, 성장하다"	
兆す	きざす	"싹트다, 징조가 보이다"	
利く	きく	"① 잘 움직이다, 기능을 발휘하다 ② 가능하다"	
きしみ合う	きしみあう	서로 다투다	
きしむ		삐걱거리다	
帰す・帰する	きす・きする	"돌아가다, ~에게 돌리다"	
期す・期する	きす・きする	기약하다	
築く	きずく	쌓다	
傷付く	きずつく	상처를 입다	
競う	きそう	다투다 경쟁하다	
来る	きたる	"오다, 다가오다"	
喫する	きっする	"마시다, 피우다, 당하다"	
興じる・興ずる	きょうじる・きょうずる	흥겨워하다	
切り出す	きりだす	말을 꺼내다	
極まる	きわまる	"극히 ~하다, ~하기 짝이 없다"	
禁じる	きんじる	금하다	
食い込む	くいこむ	"파고들다, 박히다"	
くぐる		① 빠져 나가다 ② 잠수하다	
崩す	くずす	무너뜨리다	
ぐずつく		① (하늘이) 끄무레하다 ② (아이가) 칭얼거리다	
崩れる	くずれる	무너지다	
くだす		① (지위) 낮추다 ② (명령) 내리다	
口ずさむ	くちずさむ	"읊조리다, 흥얼거리다"	
朽ち果てる	くちはてる	썩어 없어지다	
配る	くばる	나눠주다	
組み合わせる	くみあわせる	"짜맞추다, 편성하다"	
組み込む	くみこむ	"짜넣다, 편성하다"	
暮す	くらす	"살아가다, 지내다"	
繰り上げる	くりあげる	(예정보다) 앞당기다	
繰り下げる	くりさげる	뒤로 돌리다(물리다)	
企てる	くわだてる	"계획하다, 꾀하다"	
汚す	けがす	"더럽히다, (명예를) 훼손시키다"	
汚れる	けがれる	더러워지다	
蹴飛ばす	けとばす	"걷어 차다, 냅다 차다"	
煙る	けむる	"연기가 나다, 부예지다"	
心掛ける	こころがける	"항상 주의하다, 명심하다"	
試みる	こころみる	"시도해 보다, 시험해 보다"	
こす		"거르다, 여과하다"	
こだわる		"구애되다, 연연하다"	
こぼす		"① 흘리다 ② 불평하다, 푸념하다"	
こみあげる		치밀어 오르다	
込める	こめる	"넣다, 담다"	
こもる		"자욱하다, 가득 차다"	
凝らす	こらす	"(눈, 귀 등을) 한곳에 집중시키다"	
懲りる	こりる	"넌더리나다, 데다"	
凝る	こる	"① 엉기다, 응고하다 ② 열중하다"	
さえずる		(새가) 지저귀다	
さぐる		탐색하다	
裂ける	さける	"찢어지다, 갈라지다"	
避ける	さける	피하다	
支える	ささえる	"떠받치다, 지탱하다"	
捧げる	ささげる	바치다	
差し出す	さしだす	"내밀다, 제출하다, 발송하다"	
差し支える	さしつかえる	지장이 있다	
授ける	さずける	"수여하다, 하사하다"	
さする		문지르다	
定まる	さだまる	정해지다	
定める	さだめる	정하다	
悟る	さとる	깨닫다	
裁く	さばく	"시비를 가리다, 심판하다"	
さまよう		"방황하다, 헤매다"	
覚める	さめる	"깨다, 눈이 뜨이다"	
冷める	さめる	식다	
さらう		"채다, 채가다"	
仕上げる	しあげる	완성하다	
強いる	しいる	"강요하다, 강제하다"	
仕入れる	しいれる	"사들이다, 매입하다"	
しがみつく		"달라붙다, (꼭) 매달리다"	
敷く	しく	"깔다, 밑에 펴다"	
しける		습기가 차다	
沈む	しずむ	① 가라앉다 ② (해 · 달) 지다	
沈める	しずめる	"가라앉히다, 잠그다"	
親しむ	したしむ	친하게 지내다	
仕立てる	したてる	"만들다, 양성하다"	
しつける		예의 범절을 가르치다	
しなびる		시들다	
しのぐ		참고 견디다	
しぶる		"주저하다, 꺼리다"	
搾る	しぼる	짜(내)다	
仕向ける	しむける	① (어떤 태도로) 대하다 ② 발송하다	
称する	しょうする	칭하다	
しゃれる		"세련되다, 멋지다"	
据え付ける	すえつける	설치하다	
据える	すえる	"(물건을) 놓다, 설치하다"	
すく		(종이 · 김 따위를) 뜨다	
すくう		"떠내다, 뜨다, 물을 뜨다"	
すくむ		움츠러지다	
すくめる		움츠리다	
透ける	すける	"들여다 보이다, 비쳐 보이다"	
すすぐ		"① 씻다, 헹구다 ② 가시다, 양치질하다"	
薦める	すすめる	"추천하다, 천거하다"	
滑る	すべる	미끄러지다	
澄ます	すます	① 맑게 하다 ② (귀를) 기울이다	
擦る	する	"문지르다, 갈다"	
擦れる	すれる	스치다	
制する	せいする	"제지하다, 억제하다"	
切望する	せつぼうする	간절히 바라다	
狭める	せばめる	좁히다	
迫る	せまる	① (시각) 다가오다 ② (상태) 직면하다	
即する	そくする	입각하다	
損なう・損ねる	そこなう・そこねる	"① 파손하다 ② (건강 · 기분 등을) 상하게 하다, 해치다"	
唆す	そそのかす	"꼬드기다, 부추기다"	
そそる		"돋우다, 자아내다"	
備え付ける	そなえつける	"설치하다, 비치하다"	
そびえる		"우뚝 솟다, 치솟다"	
染まる	そまる	물들다	
背く	そむく	"등지다, 어기다, 거역하다"	
染める	そめる	"물들이다, 염색하다"	
そらす		(방향을) 딴 데로 돌리다	
反る	そる	"(활 모양으로) 휘다, 젖혀지다"	
耐える・堪える	たえる	"견디다, 참다"	
託す	たくす	"맡기다, 부탁하다"	
巧む	たくむ	"꾸미다, 기교를 부리다"	
たじろぐ		① 질리다 ② 주춤하다	
訪ねる	たずねる	방문하다	
漂う	ただよう	"떠돌다, 감돌다"	
立ち込める	たちこめる	(안개 · 연기 · 구름 등이) 자욱하게 끼다	
断つ	たつ	"끊다, 자르다"	
奉る	たてまつる	바치다	
たどり着く	たどりつく	겨우 다다르다	
束ねる	たばねる	"묶다, 한 뭉치로 하다"	
度重なる	たびかさなる	"거듭되다, 되풀이되다"	
たまう		"주시다, 내리시다"	
賜る	たまわる	"받다, 내려주시다"	
保つ	たもつ	유지하다	
絶やす	たやす	"① 끊어지게 하다 ② 끊다, 없애다"	
足る	たる	만족하다	
たるむ		"느슨해지다, 헤이해지다"	
垂れる	たれる	드리워지다	
違える	ちがえる	"① 달리하다 ② 틀리다, 어기다"	
縮まる	ちぢまる	"① 줄다, 감소하다 ② 움츠러들다"	
縮む	ちぢむ	"주름이 지다, 줄어들다"	
使いこなす	つかいこなす	"잘 다루다, 구사하다"	
つかえる		"막히다, 메다, 밀리다"	
仕える	つかえる	"시중들다, 섬기다"	
司る	つかさどる	"맡다, 담당하다"	
継ぐ	つぐ	"잇다, 계승하다"	
接ぐ	つぐ	접목하다	
償う	つぐなう	"갚다, 보상하다, 변상하다"	
付け加える	つけくわえる	"덧붙이다, 첨가하다"	
告げる	つげる	알리다	
伝う	つたう	(어떤 것을 따라서) 이동하다	
培う	つちかう	"가꾸다, 기르다, 배양하다"	
謹む	つつしむ	"황공해 하다, 경의를 표하다"	
慎む	つつしむ	"삼가다, 조심하다"	
つ(っ)つく		"쿡쿡 찌르다, 들추어 내다"	
突っ張る	つっぱる	"버티다, 떠받치다"	
勤まる	つとまる	"근무할 수 있다, 감당해 내다"	
務める	つとめる	"힘쓰다, 노력하다"	
つねる		꼬집다	
つぶる		(눈을) 감다	
つまむ		"집다, 집어 먹다"	
積む	つむ	"쌓다, 싣가"	
摘む	つむ	"뜯다, 따다"	
詰めかける	つめかける	"몰려들다, 밀려들다"	
連ねる	つらねる	① 늘어놓다 ② 동반하다	
連なる	つらなる	① 나란히 줄지어 있다 ② 참석하다	
手掛ける	てがける	손수 다루다	
出くわす	でくわす	(우연히) 만나다	
徹する	てっする	"철저하다, 투철하다"	
出直す	でなおす	다시 하다	
転じる・転ずる	てんじる・てんずる	전환하다	
投じる・投ずる	とうじる・とうずる	① 편승하다 ② 참여하다 ③ 항복하다 ④ 던지다	
動じる・動ずる	どうじる・どうずる	동요하다	
同じる・同ずる	どうじる・どうずる	동의하다	
尊ぶ・貴ぶ	とうとぶ	"숭상하다, 존경하다"	
遠ざかる	とおざかる	멀어지다	
遠ざける	とおざける	멀리하다	
とがめる		책망핟	
説く	とく	설득하다	
途切れる	とぎれる	"중단되다, 도중에 끊어지다"	
とじる		철하다	
途絶える	とだえる	"두절되다, 끊어지다"	
整う・調う	ととのう	"① 구비되다, 갖추어지다 ② 성립되다, 마련되다"	
整える・調える	ととのえる	"① 조정하다, 조절하다 ② 갖추다, 준비하다"	
届ける	とどける	① 보내어 주다 ② 신고하다	
とどめる		"① 멈추다, 세우다 ② 말리다 ③ 그치다, 한정시키다"	
唱える	となえる	"외치다, 주장하다, 제기하다"	
どなりこむ		"격한 소리로 항의하다, 큰 소리로 따지다"	
どなりつける		호통치다	
飛び上がる	とびあがる	"뛰어오르다, (놀람 · 기쁨으로) 펄쩍 뛰다"	
飛び歩く	とびあるく	뛰어다니다	
飛び交う	とびかう	어지럽게 날다	
飛び掛かる	とびかかる	"대들다, 덤벼들다"	
飛び越す	とびこす	"뛰어넘다, 앞지르다"	
飛び散る	とびちる	"사방에 흩날리다, 비상하다"	
飛び抜ける	とびぬける	"크게 차이나다, 뛰어나다"	
飛び離れる	とびはなれる	큰 차이가 나다	
とぼける		"얼빠지다, 시치미를 떼다"	
止まる	とまる	"멈추다, 그리다"	
富む	とむ	"재산이 많다, ~이 풍부하다"	
取り合わせる	とりあわせる	(적절히) 배합하다	
取り入る	とりいる	"환심사다, 아첨하다"	
取り押さえる	とりおさえる	"억누르다, 붙잡다"	
取り崩す	とりくずす	"헐다, 무너뜨리다"	
取り越す	とりこす	"앞당겨서 하다, 앞당기다"	
取り下げる	とりさげる	"취하하다, 철회하다"	
取り仕切る	とりしきる	혼자 도맡아 하다	
取り締まる	とりしまる	"다잡다, 단속하다"	
取り調べる	とりしらべる	"조사하다, 문초하다"	
取り揃える	とりそろえる	"골고루 갖추다, 한데 모으다"	
取り立てる	とりたてる	① 징수하다 ② 발탁하다	
取り付く	とりつく	① 매달리다 ② 착수하다	
取り付ける	とりつける	"달다, 장치하다"	
取りとめる	とりとめる	① 멈추다 ② 명확히 하다	
取り成す	とりなす	"잘 꾸리다, 수습하다"	
取り除く	とりのぞく	제거하다	
取り外す	とりはずす	"떼다, 빼다, 해체하다"	
取り巻く	とりまく	"둘러싸다, 에워싸다"	
取り混ぜる	とりまぜる	"한데 섞다, 뒤섞다"	
取り持つ	とりもつ	① 손에 쥐다 ② 주선하다	
取り寄せる	とりよせる	(주문해서) 가져오게 하다(시키다)	
とろける		녹다	
萎える	なえる	"힘이 풀리다, 쇠약해지다"	
なじる		"힐책하다, 따지다"	
なぞる		"(글씨 · 그림 위에) 덧쓰다, 본뜨다"	
なめる		① 핥다 ② (쓰라림을) 겪다 ③ 깔보다	
慣らす	ならす	길들이다	
似通う	にかよう	"서로 잘 닮다, 서로 비슷하다"	
似る	にる	닮다	
抜かす	ぬかす	바뜨리다	
ねじれる		"비뚤어지다, 꼬이다"	
ねたむ		"시기하다, 질투하다"	
ねだる		"조르다, 졸라대다"	
粘る	ねばる	① 잘 달라붙다 ② 끈덕지게 버티다	
粘り着く	ねばりつく	끈적끈적 달라붙다	
狙う	ねらう	노리다	
練る	ねる	"① 반죽하다 ② (계획 · 문장 등) 다듬다, 짜다"	
逃す	のがす	놓치다	
則る	のっとる	"따르다, 본받다"	
乗っ取る	のっとる	① 빼앗다 ② 납치하다	
ののしる		"욕을 퍼붓다, 매도하다"	
飲み込む	のみこむ	"① 삼키다 ② 이해하다, 납득하다 ③ 수용하다"	
載る	のる	"(신문, 잡지에) 실리다"	
計らう	はからう	"상의하다, 봐주다"	
図る	はかる	"꾀하다, 도모하다"	
謀る	はかる	"꾀하다, 꾸미다"	
諮る	はかる	"의견을 묻다, 상의하다"	
はぐ		① (껍질 등을) 벗기다 ② 박탈하다	
育む	はぐくむ	"기르다, 새끼를 품어 기르다"	
博す・博する	はくす・はくする	① (명성 등을) 떨치다 ② (이익을) 독차지하다	
はげる		① (칠 등이) 벗겨지다 ② (머리가) 벗어지다	
ばける		"둔갑하다, 가장하다"	
はじく		"튀기다, 튕겨 내다"	
恥じらう	はじらう	"부끄러워하다, 수줍어하다"	
恥じる	はじる	부끄러워하다	
走り抜ける	はしりぬける	① 빠져나가다 ② 끝까지 뛰다	
はたく		"치다, 때리다"	
発する	はっする	"① 발하다, 출발하다 ② 시작하다"	
果てる	はてる	끝나다	
跳ね上がる	はねあがる	"뛰어오르다, 날뛰다"	
跳ね返る	はねかえる	튀어서 되돌아오다	
はねつける		무정하게 거절하다	
はねる		받아서 나가떨어지게 하다	
はばかる		"꺼리다, 삼가다, 주저하다"	
はまる		"꼭 맞다, 채워지다"	
晴らす	はらす	(불쾌감 · 의심 등) 해소시키다	
ばらす		"분해하다, 해체하다"	
ばらまく		흩뿌리다	
張り裂ける	はりさける	(가슴이) 미어 터지다	
張り出す・貼り出す	はりだす	"게시하다, 내어 붙이다"	
はれる		붓다	
ばれる		"탄로나다, 발각되다, 들키다"	
秀でる	ひいでる	뛰어나다	
控える	ひかえる	① 삼가다 ② 앞두다	
引き上げる	ひきあげる	끌어올리다	
率いる	ひきいる	"거느리다, 인솔하다"	
引き起こす	ひきおこす	일으키다	
引き落とす	ひきおとす	① 자동이체하다 ② 감산하다	
引き下げる	ひきさげる	"내리다, 인하하다"	
引きずる	ひきずる	질질 끌다	
ひしめく		북적거리다	
引き取る	ひきとる	① 물러나다 ② 숨을 거두다 ③ 떠맡다	
ひずむ		"일그러지다, 비뚤어지다"	
ひそむ		숨다	
ひそめる		"찌푸리다, 찡그리다"	
浸す	ひたす	담그다	
引っ搔く	ひっかく	할퀴다	
冷やかす	ひやかす	① 놀리다 ② (살 생각도 없이) 물건을 보거나 값만 물어 보다	
ひらめく		(생각이) 번쩍 떠오르다	
広まる	ひるまる	"넓어지다, 번지다, 퍼지다"	
深める	ふかめる	깊게 하다	
膨れる	ふくれる	부풀다	
ふける		열중하다	
老ける	ふける	늙다	
踏まれる	ふまれる	입각하다	
踏み込む	ふみこむ	발을 들여 놓다	
震わせる	ふるわせる	"떨다, 떨게 하다"	
隔たる	へだたる	"(거리가) 떨어지다, 멀어지다"	
報じる・報ずる	ほうじる・ほうずる	① 보답하다 ② 보도하다	
葬る	ほうむる	매장하다	
放り込む	ほうりこむ	(아무렇게나) 넣다	
ぼける		"둔해지다, 흐려지다"	
誇る	ほこる	자랑하다	
ほころびる		"터지다, 풀리다"	
ぼやく		투덜거리다	
ぼやける		희미해지다	
滅ぼす	ほろぼす	멸망시키다	
舞う	まう	"춤추다, 흩날리다"	
負かす	まかす	"지게 하다, 이기다"	
任す	まかす	맡기다	
紛れる	まぎれる	"① 헷갈리다, (비슷해서) 분간 못하다 ② 틈타다"	
まく		뿌리다	
まごつく		"당황하다, 망설이다"	
勝る	まさる	"낫다, 뛰어나다"	
交わる	まじわる	① 교차하다 ② 뒤섞이다	
またがる		"걸치다, 올라타다"	
待ち望む	まちのぞむ	기다리고 기다리다	
まつわる		"달라붙다, 얽히다"	
まとう		"감다, (몸에) 걸치다, 입다"	
惑う	まどう	"갈팡거리다, 망설이다"	
惑わす	まどわす	"혼란시키다, 유혹하다"	
免れる	まぬかれる・まぬがれる	"모면하다, 벗어나다"	
見合わせる	みあわせる	"보류하다, 미루다"	
見入る	みいる	열심히 보다	
見落とす	みおどす	"간과하다, 빠뜨리다"	
磨く	みがく	"닦다, 연마하다"	
見せ付ける	みせつける	과시하다	
見せびらかす	みせびらかす	과시하다	
乱す	みだす	"어지럽히다, 흩트리다"	
見とれる	みとれる	넋을 잃고 보다	
みなす		간주하다	
見習う	みならう	"본받다, 견습하다"	
見抜く	みぬく	"간파하다, 꿰뚫어보다"	
見逃す	みのがす	"놓치다, 못 보다"	
見計らう	みはからう	"가늠보다, 적당히 고르다"	
見守る	みまもる	지켜보다	
診る	みる	진찰하다	
見渡す	みわたす	"멀리 바라다보다, 전망하다"	
報いる	むくいる	"보답하다, 갚다"	
貪る	むさぼる	탐하다	
むしる		"쥐어뜯다, 잡아뽑다, 떼어내다"	
結び付く	むすびつく	"결부되다, 이어지다"	
結び付ける	むすびつける	결합시키다	
群がる	むらがる	군집하다	
めくる		"넘기다, 젖히다"	
召す	めす	먹다 · 마시다 · 입다 등의 높임말	
免じる・免ずる	めんじる・めんずる	면제하다	
申し入れる	もうしいれる	"제의하다, 제기하다"	
申し出る	もうしでる	"자청하다, 신청하다"	
燃える	もえる	타다	
もがく		발버둥치다	
もたらす		"가져오다, 초래하다"	
もてあます		"힘에 겨워하다, 주체 못하다"	
戻す	もどす	되돌리다	
基づく	もとづく	"기초를 두다, 의거하다"	
もめる		"분규가 일어나다, 옥신각신하다"	
漏らす	もらす	"새게 하다, 누설하다"	
漏る	もる	(물 등이) 새다	
漏れる	もれる	"새다, 누설되다"	
安らぐ	やすらぐ	(마음이) 편안해지다	
破る	やぶる	"깨다, 어기다"	
病む	やむ	"병들다, 앓다"	
辞める	やめる	"그만두다, 사직하다"	
やり遂げる	やりとげる	"완수하다, 끝까지 해내다"	
やり通す	やりとおす	끝까지 하다	
和らぐ	やわらぐ	"누그러지다, (마음이) 풀리다"	
和らげる	やわらげる	완화시키다	
有する	ゆうする	"가지다, 소유하다"	
ゆがむ		"비뚤어지다, 일그러지다"	
ゆすぐ		"헹구다, (입을) 가시다"	
揺する	ゆする	흔들다	
委ねる	ゆだねる	"맡기다, 위임하다"	
揺る	ゆる	흔들다	
緩む	ゆるむ	"헐렁해지다, 누그러지다"	
緩める	ゆるめる	"늦추다, 완화하다"	
結わえる	ゆわえる	"매다, 묶다"	
要する	ようする	"요하다, 필요로 하다"	
よける		"피하다, 옆으로 비키다"	
寄せる	よせる	① 밀려오다 ② 바싹 대다	
装う	よおそう	① 치장하다 ② 가장하다	
よみがえる		되살아나다	
寄り掛かる	よりかかる	"기대다, 의존하다"	
あくどい		"악랄하다, 악착같다"	
あっけない		"어이없다, 싱겁다"	
あどけない		천진난만하다	
怪しい	あやしい	"수상하다, 괴상하다"	
荒っぽい	あらっぽい	"거칠다, 난폭하다"	
いじらしい		"애처롭다, 안쓰럽다"	
意地悪い	いじわるい	"심술궂다, 짓궂다"	
いたわしい		"가엾다, 애처롭다"	
著しい	いちじるしい	현저하다	
卑しい	いやしい	"천하다, 치사하다"	
疎い	うとい	"(사이가) 멀다, 소원하다"	
うるさい		① 시끄럽다 ② 까다롭다	
奥床しい	おくゆかしい	"은근하다, 그윽하다"	
おびただしい		(수 · 양이) 엄청나다	
重々しい	おもおもしい	엄숙하고 무게가 있다	
かいがいしい		바지런하다	
限りない	かぎりない	"무한하다, 한없다"	
かなわない		견딜 수 없다	
ぎこちない		"딱딱하다, 어색하다"	
厳しい	きびしい	엄격하다	
決まり悪い	きまりわるい	"쑥스럽다, 창피하다"	
極まりない	きわまりない	한이 없다	
くすぐったい		"간지럽다, 낯간지럽다"	
けがらわしい		"더럽다, 추잡스럽다"	
けばけばしい		"요란하다, 현란하다"	
心細い	こころぼそい	불안하다	
快い	こころよい	기분이 좋다	
好ましい	このましい	"마음에 들다, 호감이 가다"	
渋い	しぶい	떫다	
すがすがしい		상쾌하다	
せこい		"교활하다, 믿을 수 없다"	
せつない		애달프다	
そっけない		"무정하다, 쌀쌀맞다"	
耐えがたい	たえがたい	견딜 수 없다	
たくましい		늠름하다	
たどたどしい		"더듬거리다, 비틀거리다"	
たゆみない		"게으름 피우지 않다, 한결같다"	
手厚い	てあつい	"극진하다, 융숭하다"	
手荒い	てあらい	"난폭하다, 거칠다"	
手厳しい	てきびしい	매우 엄하다	
手ぬるい	てぬるい	미온적이다	
尊い・貴い	とうとい	"소중하다, 귀중하다"	
乏しい	とぼしい	"부족하다, 가난하다"	
情けない	なさけない	한심하다	
情け深い	なさけぶかい	인정이 많다	
何気ない	なにげない	아무렇지도 않다	
生臭い	なまぐさい	비린내가 나다	
悩ましい	なやましい	"괴롭다, 고통스럽다"	
粘り強い	ねばりづよい	끈기 있다	
はかない		"덧없다, 무상하다"	
甚だしい	はなはだしい	"심하다, 대단하다"	
ふさわしい		어울리다	
待ち遠しい	まちどおしい	몹시 기다려지다	
真ん丸い	まんまるい	아주 둥글다	
みすぼらしい		초라하다	
蒸し暑い	むしあつい	무덥다	
むつまじい		"사이가 좋다, 정답다"	
空しい	むなしい	"공허하다, 허무하다"	
目まぐるしい	めまぐるしい	어지럽다	
物々しい	ものものしい	어마어마하다	
もろい		"약하다, 여리다"	
余儀ない	よぎない	어쩔(하는) 수 없다	
欲深い	よくぶかい	욕심이 많다	
よそよそしい		서먹서먹하다	
わずらわしい		"귀찮다, 성가시다"	
哀切な	あいせつな	애절한	
浅はかな	あさはかな	"생각이 얕은, 어리석은"	
鮮やかな	あざやかな	"또렷한, 선명한"	
艶やかな	あでやかな	"아리따운, 요염한"	
あやふやな		"불확실한, 모호한"	
新たな	あらたな	새로운	
安穏な	あんのんな	안온한	
いい加減な	いいかげんな	"무책임한, 엉터리인"	
意外な	いがいな	의외인	
粋な	いきな	"멋진, 세련된"	
嫌味な	いやみな	"불쾌한, 아니꼬운"	
陰気な	いんきな	"음울한, 음침한"	
淫乱な	いんらんな	음란한	
鋭利な	えいりな	예리한	
円滑な	えんかつな	원활한	
婉曲な	えんきょくな	완곡한	
円満な	えんまんな	원만한	
旺盛な	おうせいな	왕성한	
おおまかな		"대범한, 대충하는"	
臆病な	おくびょうな	겁이 많은	
厳かな	おごそかな	엄숙한	
穏やかな	おだやかな	온화한	
温和な	おんわな	온화한	
果敢な	かかんな	과감한	
確実な	かくじつな	확실한	
過激な	かげきな	과격한	
苛酷な	かこくな	가혹한	
過酷な	かこくな	지나치게 가혹한	
過敏な	かびんな	과민한	
過密な	かみつな	"과밀한, 빽빽한"	
華麗な	かれいな	화려한	
簡潔な	かんけつな	간결한	
肝心な	かんじんな	"긴요한, 중요한"	
寛大な	かんだいな	관대한	
気軽な	きがるな	"소탈한, 선선한"	
気さくな	きさくな	싹싹한	
きちょうめんな		규칙적이고 꼼꼼한	
希薄な	きはくな	희박한	
きゃしゃな		갸냘픈	
窮屈な	きゅうくつな	"거북한, 답답한, 비좁은"	
強固な	きょうこな	"공고한, 강경한"	
狭小な	きょうしょうな	"협소한, 비좁은"	
強大な	きょうだいな	"강대한, 강력한"	
強烈な	きょうれつな	강렬한	
清らかな	きよらかな	"맑은, 깨끗한"	
きらびやかな		눈부시게 화려한	
軽易な	けいいな	"간단한, 손쉬운"	
軽快な	けいかいな	경쾌한	
軽率な	けいそつな	경솔한	
軽薄な	けいはくな	경박한	
厳重な	げんじゅうな	엄중한	
厳粛な	げんしゅくな	엄숙한	
賢明な	けんめいな	현명한	
豪華な	ごうかな	호화로운	
高潔な	こうけつな	고결한	
高尚な	こうしょうな	고상한	
高慢な	こうまんな	"거만한, 건방진"	
傲慢な	ごうまんな	"오만한, 거만한"	
酷烈な	こくれつな	"혹렬한, 혹독하고 심한"	
滑けいな	こっけいな	"우스운, 우스꽝스러운"	
こまやかな		"자상한, 세밀한"	
残酷な	ざんこくな	"잔혹한, 참혹한"	
散漫な	さんまんな	산만한	
したたかな		"여간이 아닌, 만만치 않은"	
失敬な	しっけいな	"버릇없는, 무례한, 실례인"	
質素な	しっそな	검소한	
淑やかな	しとやかな	"정숙한, 우아한"	
充実な	じゅうじつな	충실한	
従順な	じゅうじゅんな	"온순한, 다소곳한"	
周到な	しゅうとうな	"주도면밀한, 빈틈없는"	
柔軟な	じゅうなんな	유연한	
深厚な	しんこうな	깊고 두터운	
迅速な	じんそくな	신속한	
親密な	しんみつな	"친밀한, 친한"	
粋な	すいな	풍류를 즐기는	
健やかな	すこやかな	"튼튼한, 건강한"	
素直な	すなおな	"순진한, 솔직한"	
速やかな	すみやかな	"빠른, 신속한, 조속한"	
精巧な	せいこうな	정교한	
誠実な	せいじつな	성실한	
静粛な	せいしゅくな	정숙한	
成熟な	せいじゅくな	성숙한	
清純な	せいじゅんな	청순한	
鮮烈な	せんれつな	선명하고 강한	
疎遠な	そえんな	소원한	
早急な	そうきゅうな・さっきゅうな	"조급한, (매우) 급한"	
素朴な	そぼくな	소박한	
ぞんざいな		"일을 소홀히 하는, 겉날리는"	
大胆な	だいたんな	대담한	
堪能な	たんおうな	(그 길에) 뛰어난	
淡白な	たんぱくな	"담백한, 산뜻한"	
稚拙な	ちせつな	"치졸한, 서투른"	
緻密な	ちみつな	치밀한	
著名な	ちょめいな	저명한	
陳腐な	ちんぷな	진부한	
痛快な	つうかいな	통쾌한	
痛切な	つうせつな	"통절한, 절실한"	
つぶらな		동그랗고 귀여운	
強気な	つよきな	"(성미가) 강한, 강경한"	
強腰な	つよごしな	"태도가 강경한, 고자세의"	
丁重な	ていちょうな	"정중한, 극진한"	
丁寧な	ていねいな	"① 친절한, 공손한 ② 꼼꼼한"	
手近な	てぢかな	가까이 있는	
徹底な	てっていな	철저한	
唐突な	とうとつな	당돌한	
得意な	とくいな	특이한	
突飛な	とっぴな	"엉뚱한, 별난"	
鈍感な	どんかんな	둔감한	
和やかな	なごやかな	"부드러운, 온화한"	
苦手な	にがてな	"잘 못하는, 서투른"	
柔和な	にゅうわな	"온유한, 온화한"	
懇ろな	ねんごろな	친절하고 공손한	
濃厚な	のうこうな	농후한	
濃密な	のうみつな	"농밀한, 진한"	
のどかな	のどかな	① 한가로운 ② 날씨가 화창한	
博識な	はくしきな	박식한	
抜本的な	ばっぽんてきな	발본적인	
華やかな	はなやかな	화려한	
はるかな		(거리가) 아득한	
繫雑な	はんざつな	"번잡한, 일이 많고 복잡한"	
半端な	はんぱな	"불완전한, 어중간한"	
ひろかな		은밀한	
微妙な	びみょうな	미묘한	
不穏な	ふおんな	불온한	
不確かな	ふたしかな	"불확실한, 애매한"	
不調な	ふちょうな	"상태가 나쁜, 부진한"	
不当な	ふとうな	"부당한, 정당하지 않은"	
無難な	ぶなんな	무난한	
豊富な	ほうふな	풍부한	
凡庸な	ぼんような	"범용적인, 평범한"	
まどかな		"원만한, 평온한"	
まともな		착실한	
未熟な	みじゅくな	미숙한	
淫らな	みだらな	"음란한, 난잡한"	
身近	みぢか	"① 자기 몸에 가까운 곳, 신변 ② 긴밀함"	
無邪気な	むじゃきな	"천진한, 순진한, 악의 없는"	
無尽蔵な	むじんぞうな	"무진장, 무궁무진한"	
無茶な	むちゃな	"터무니 없는, 당치 않은"	
むちゃくちゃな		"엉망진창인, 터무니 없는"	
夢中な	むちゅうな	"열중한, 몰두한"	
無能な	むのうな	무능한	
明朗な	めいろうな	명랑한	
猛烈な	もうれつな	맹렬한	
憂鬱な	ゆううつな	우울한	
有益な	ゆうえきな	유익한	
勇敢な	ゆうかんな	용감한	
雄大な	ゆうだいな	웅대한	
有望な	ゆうぼうな	유망한	
緩やかな	ゆるやかな	"완만한, 느릿한, 느슨한"	
容易な	よういな	용이한	
妖艶な	ようえんな	요염한	
律儀な・律義な	りちぎな	"의리가 두터운, 성실하고 정직한"	
理不尽な	りふじんな	"불합리한, 무리한"	
冷厳な	れいげんな	냉엄한	
冷酷な	れいこくな	냉혹한	
零細な	れいさいな	영세한	
冷淡な	れいたんな	냉담한	
歴然な	れきぜんな	"분명한, 또렷한"	
老練な	ろうれんな	노련한	
ろくな		"변변한, 제대로인"	
あっさり		"담박하게, 산뜻하게, 시원스럽게"	
あながち		① 반드시 ② 억지로	
あまりにも		"너무나도, 지나치게"	
あらかじめ		미리	
あらわに		"노골적으로, 공공연히"	
ありのままに		"있는 그대로, 사실대로"	
案外	あんがい	의외로	
いかにも		"정말, 매우"	
いざ		"자, 막상, 남을 권유할 때"	
依然として	いぜんとして	여전히	
一概に	いちがいに	"일률적으로, 무조건"	
いちいち		"일일이, 하나하나"	
一応	いちおう	"우선, 일단"	
一面	いちめん	① 일면 ② 온통	
いつかしら		"어느 결에, 모르는 사이에, 언젠가는"	
一見	いっけん	언뜻 보기에	
いっそ		차라리	
いったん		"① 일단 ② 잠시, 잠깐"	
未だ	いまだ	아직	
未だに	いまだに	"아직껏, 아직까지도, 현재까지도"	
今や	いまや	"지금이야말로, 바야흐로, 지금은"	
嫌々	いやいや	"싫으나 할 수 없이, 마지못해서"	
いやに		"① 대단히, 몹시 ② 묘하게, 이상하게"	
うっかり		깜빡	
うっとり		넋을 잃고	
えてして		"자칫하면, 까딱하면"	
おおかた		"거의, 대강"	
おどおど		쭈뼛쭈뼛	
おろおろ		허둥거림(어찌할 바를 몰라 당황하는 모양)	
がっくり(と)		"폭, 덜컥, 맥없이"	
がっしり		"(체격이나 짜임새가) 실팍한, 딱 벌어진, 야무지게"	
がっちり		"단단히, 꽉, 야무진, 빈틈없이"	
かねて		"미리, 전부터"	
兼ねて	かねて	"겸하여, 또"	
かろうじて		"겨우, 간신히"	
きちっと・きちんと		"깔끔히, 규칙적으로"	
きっかり		"꼭, 딱(꼭 들어맞아서 우수리가 없는 모양)"	
ぎっしり		"가득, 잔뜩"	
きっちり		꼭 맞는 모양	
きっぱり(と)		"단호히, 딱 잘라"	
急遽	きゅうきょ	갑작스럽게	
くそみそに		"호되게, 마구"	
口酸っぱく	くちすっぱく	입이 닳도록	
くっきり		"뚜렷하게, 선명하게"	
ぐっすり		푹(깊은 잠을 자는 모양)	
ぐっと		"꿀꺽, 홱, 힘껏, 훨씬"	
くまなく		"구석구석까지, 샅샅이, 빠짐없이"	
くれぐれも		"부디, 아무쪼록"	
くよくよ		끙끙(사소한 일을 걱정하여 고민하는 모양)	
げっそり		홀쭉(갑자기 여위는 모양)	
こうこうと		휘황찬란하게(번쩍번쩍 빛나는 모양)	
ごっそり		"모두, 몸땅"	
殊に	ことに	"각별히, 특히"	
ごぼごぼ		콸콸	
さしたる		"이렇다 할, 별반의"	
さだめし		"틀림없이, 아마"	
さっぱり(と)		"산뜻한 모양, (맛 등) 담백함, 남김없이"	
さまで		그렇게(까지) <부정 수반>	
さも		"자못, 아주, 정말로"	
さらさら		"① 결코, 조금도 ② 졸졸, 보슬보슬, 사각사각"	
散々	さんざん	"몹시, 실컷, 단단히, 호되게"	
しなしな		"(몸매 등이) 나긋나긋, 하늘하늘"	
暫く	しばらく	① 잠깐 ② 당분간	
じめじめ		"축축, 질퍽질퍽"	
主として	しゅとして	주로	
瞬時	しゅんじ	"순식간, 잠시"	
じりじりと		쨍쨍(태양 따위가 내리쬐는 모양)	
じりじりする		바작바작 속을 태우다	
じわじわ		"서서히, 조금씩"	
しんなり		나긋나긋	
少なからず	すくなからず	"적지않게, 많이"	
ずばりと		"① (칼로) 싹둑 ② 정확히, 딱 (잘라)"	
ずらっと		"죽, 여럿이 늘어선 모양"	
すらりと・すらっと		"술술, 쑥(막힘이 없는 모양)"	
ずるずる		질질(질질 끌거나 끌리는 모양)	
すんなり		"① 매끈함 ② (일이) 척척, 순조롭게"	
精一杯	せいいっぱい	"① 힘껏, 최대한으로 ② 고작"	
せいぜい		"기껏, 겨우, 고작"	
ぜひとも		"꼭, 무슨 일이 있어도"	
漸次	ぜんじ	"점차, 차차, 점점"	
そわそわ		"마음이 불안정함, 불안한 표정임"	
互いに	たがいに	"서로, 다 함께"	
だぶだぶ		헐렁헐렁	
だらだら		"질질, 완만하게, 지루하게"	
ちやほや		얼러주는 모양	
ちょくちょく		"이따금, 가끔"	
ちょっぴり		"조금, 약간"	
ちらっと・ちらりと		"흘끗, 언뜻"	
遂に	ついに	"드디어, 마침내, 결국"	
つくづく		"정말, 아주, 절실히"	
つと・つっと		"척, 쑥, 불쑥, 우뚝, 쭉"	
努めて	つとめて	"가능한 한, 될 수 있는 대로, 애써"	
手軽に	てがるに	"간편하게, 손쉽게"	
てきぱきと		척척(일을 척척 잘 해내는 모양)	
てっきり		"틀림없이, 영락없이"	
とうてい		도저히	
堂々と	どうどうと	"당당히, 버젓이"	
どうにか		"그럭저럭, 겨우"	
どうやら		"아무래도, 아마, 그럭저럭"	
どうりで		"그 때문에, 어쩐지, 과연"	
とかく		"이것저것, 어쨌든"	
時折	ときおり	"때때로, 이따금"	
どことなく		어딘지 (모르게)	
どたばた		"우당탕, 요란스럽게"	
とりあえず		"부랴부랴, 즉각, 우선"	
取り急ぎ	とりいそぎ	급히	
とりたてて		각별히	
とりわけ		"특히, 그 중에서도"	
とろとろ		"눅진눅진, 끈적끈적"	
どろどろ		"질척질척, 흐물흐물"	
どんより(と)		날씨가 잔뜩 흐린 모양	
尚更	なおさら	"더더욱, 더한층"	
長々	ながなが	"오랫동안, 길게, 장황하게"	
なるたけ		"되도록, 될 수 있는 대로"	
なんだかんだ		"이것저것, 이러니저러니"	
なんと		"얼마나, 대단히, 참"	
なんという		① 어쩌면 ② 이렇다 할	
なんなりと		"무엇이든(지), 무엇이건"	
ねちねち		"끈적끈적, 치근치근"	
のきなみ		"일제히, 다 함께"	
はっと		"문득, 언뜻"	
はらはら		조마조마	
はるかに		"훨씬, 매우"	
はらばら		멀리	
ひいては		(한층 더) 나아가서는	
ひそひそ		소곤소곤	
ひたすら		"오로지, 오직, 한결같이"	
ひょっと		"뜻밖에, 불쑥"	
ぴんぴん		"펄떡펄떡, 팔팔"	
ひんやり		"썰렁, 선뜩(찬 기운을 느끼는 모양)"	
ふいに		"갑자기, 느닷없이"	
再び	ふたたび	"다시, 재차"	
ふらふらと		비틀거리며	
べとべと		끈적끈적	
ぼうぜんと		멍하니	
まして		"하물며, 더구나"	
まるっきり		"도무지, 전혀"	
丸々	まるまる	"전부, 완전히"	
まんざら		반드시 (~한 것만은 아니다)	
漫然と	まんぜんと	"산만하게, 멍하게"	
自ら	みずから	스스로	
みすみす		"빤히, 보고도, 눈뜨고"	
みるみるうちに		"순식간에, 삽시간에"	
むげに		"함부로, 딱 잘라"	
無性に	むしょうに	"몹시, 공연히, 까닭없이"	
めきめき		"눈에 띄게, 두드러지게, 무럭무럭"	
めそめそ		훌쩍훌쩍	
もはや		"이제는, 벌써"	
もろもろ		"여러 가지, 가지가지"	
やけに		"몹시, 지독히, 매우"	
やんわりと		"부드럽게, 온화하게, 살며시"	
ゆるゆる		"천천히, 느릿느릿"	
よくも		"잘도, (반어적으로) 어쩌면"	
よほど		"훨씬, 상당히"	
よもや		설마	
ろくに		"변변히, 제대로"	
わざわざ		일부러	
わりに		"비교적, 생각한 것보다는"	
アクセル		"액셀, 가속 장치"	
アピール		"어필, 호소, 공감, 항의"	
アンコール		"앙코르, 재청"	
インターチェンジ		"인터체인지, IC"	
インターン		"인턴, 실습생"	
インテリ		"인텔리, 지식인"	
インテリア		"인테리어, 실내 장식"	
インフルエンザ		독감	
インフレ		인플레이션	
ウエット		정에 무름	
ウェブ		웹	
エース		"에이스, 제1인자"	
エピローグ		에필로그	
エレガント		우아함	
エントリー		"엔트리, 참가 신청"	
オプション		옵션	
オリエンテーション		오리엔테이션	
ガード		"(도로 · 선로 위의) 철교, 육교"	
ガードレール		가드레일	
カーペット		"카펫, 융단"	
カウンター		"카운터, 계산대"	
カウント		"카운트, 셈, 계산"	
カテゴリー		"카테고리, 범주"	
カルテ		"카르테, 진료 기록 카드"	
ガレージ		차고	
キープ		"자기 수중에 가짐, 확보함"	
ギブアップ		"기브 업, 단념함"	
キャスター		"캐스터, 해설자"	
キャスト		"캐스트, 배역"	
キャッチ		캐치	
キャップ		"캡, 뚜껑"	
キャラクター		"캐릭터, 성격, 성질"	
キャリア		"커리어, 경력"	
クリア		"장애물을 뛰어넘음, 난관을 헤쳐나감"	
クレーム		"클레임, 불평, 불만"	
クローズアップ		클로즈업	
グローバル		"글로벌, 세계적임"	
コーディネーター		코디네이터	
コネクション・コネ		"연고, 연줄"	
コマーシャル		"커머셜, 방송 광고"	
コミュニケーション		커뮤니케이션	
サイクル		사이클	
サポーター		"서포터, 후원자, 지지자"	
シート		시트	
シェア		"셰어, 시장 점유율"	
シック		"멋짐, 세련됨"	
ジャズ		재즈	
シャトル		"셔틀, 정기 왕복편"	
ジャンプ		"점프, 뜀, 도약"	
ジャンボ		"점보, 거대함"	
スクラップ		"스크랩, 고철"	
スタイル		스타일	
スタジオ		"스튜디오, 활영실"	
ステーション		"역, 정거장"	
ステータス		"사회적 지위, 신분"	
ストライキ・スト		동맹 파업	
ストロー		"스트로우, 빨대"	
ストロボ		"스트로보, 섬광 장치"	
スポンサー		"스폰서, 광고주, 후원자"	
スリル		스릴	
スローガン		슬로건	
ソックス		양말	
ダース		다스(12개로 한 조)	
タイムリー		시의적절함	
タッチ		"터치, 감촉"	
タレント		"탤런트, 재능이 있는 사람"	
チャイム		차임(벨)	
チャージ		"차지, 충전"	
チャンネル		채널	
ティッシュ・ペーパー		화장지	
データベース		데이터베이스	
デザイン		디자인	
デッサン		"데생, 소모"	
テナント		"테넌트, 세입자"	
デビュー		데뷔	
デフレ		디플레이션	
ドライ		"드라이, 매몰참"	
トリック		"트릭, 책략, 속임수"	
ドリル		"드릴, 반복 연습"	
ナンセンス		"넌센스, 무의미함"	
ニュアンス		뉘앙스	
ノイローゼ		노이로제	
バッジ		"배지, 휘장"	
バッテリー		배터리	
バット		배트	
パトカー		"패트롤카, 순찰자"	
パロディー		패러디	
ファイル		"파일, 서류철"	
フィルター		필터	
フェリー		페리	
フォーム		"폼, 모양"	
ブザー		"버저, 초인종"	
フラッシュ		플래시	
ブランド		"브랜드, 상표"	
ブロック		블록	
プロローグ		"프롤로그, 서막"	
フロント		"정면, (호텔의) 접수계"	
ペア		"페어, 한 쌍, 짝"	
ベース		"베이스, 토대, 기초"	
ボイコット		"보이콧, 불매 동맹"	
ポジション		"(직무상의) 지위, 수비 위치"	
マージン		"마진, 이문"	
マスコミ		매스컴	
マスメディア		매스 미디어	
マッサージ		마사지	
ムード		"무드, 분위기"	
メディア		"미디어, 매체"	
メロディー		"멜로디, 선율"	
ウニフォーム		"유니폼, 제복"	
ユーモア		유머	
ランク		"랭크, 순위를 정함"	
リアリティー		"리얼리티, 현실(성)"	
リストアップ		"리스트 업, 열거"	
ルーズ		"단정치 못함, 허술함"	
レッテル		"상표지, 라벨"	
レギュラー		"레귤러, 정규멤버"	
レバー		"레버, 지렛대"	
レベル		"레벨, 수준"	
レントゲン		"뢴트겐, 엑스레이"	
ロケーション・ロケ		"로케이션, 현지 촬영"	
ロック		자물쇠를 채움	
ロマンチック		"로맨틱, 낭만적"	
ワット		와트	
悪平等	あくびょうどう	"악평등, 잘못된 평등"	
来る十日	きたるとおか	오는 10일	
誤操作	ごそうさ	오조작	
去る五日の朝	さるいつかのあさ	지난 닷샛날 아침	
超満員	ちょうまんいん	초만원	
当ホテル	とうほてる	저희 호텔	
当研究所	とうけんきゅうじょ	당연구소	
被任命者	ひにんめいしゃ	임명받은 사람	
副作用	ふくさよう	부작용	
猛反対	もうはんたい	맹반대	
生産額	せいさんがく	생산액	
汚職がらみ		비리에 관련됨	
50がらみ		50(세) 가량	
人生観	じんせいかん	인생관	
家族ぐるみ		온 가족이 몽땅	
首都圏	しゅとけん	수도권	
供給源	きょうきゅうげん	공급원	
乗り心地	のりごこち	승차감	
住み心地	すみごこち	거주했을 때의 기분	
発送先	はっそうさき	발송처	
報道陣	ほうどうじん	보도진	
決勝戦	けっしょうせん	결승전	
探検隊	たんけんたい	탐험대	
資金難	しきんなん	자금난	
人間味	にんげんみ	인간미	
通信網	つうしんもう	통신망	
広告欄	こうこくらん	광고란	
死亡率	しぼうりつ	사망률	
盛況裏	せいきょうり	성황리	
着こなす	きこなす	맵시 있게 입다	
使いこなす	つかいこなす	잘 다루다	
弾きこなす	ひきこなす	잘 연주하다	
思い込む	おもいこむ	믿어버리다	
飛び込む	とびこむ	뛰어들다	
割り込む	わりこむ	끼어들다	
受け損ねる	うけそこねる	받을 기회를 놓치다	
聞き損ねる	ききそこねる	"잘못 듣다, 못 듣다"	
乗り損ねる	のりそこねる	(탈것을) 놓치다	
行きそびれる	いきそびれる	갈 기회를 놓치다	
言いそびれる	いいそびれる	말할 기회를 놓치다	
証	あかし	"증거, 증명"	
暁	あかつき	"새벽, 새벽녘"	
夜明け	よあけ	"새벽, 새벽녘"	
商い	あきない	장사	
諦念	ていねん	체념	
憧憬	どうけい・しょうけい	동경	
卑劣な	ひれつな	비열한	
あさましい		"비열하다, 치사하다"	
アシスタント		"어시스턴트, 조수, 보조역"	
助手	じょしゅ	조수	
あたかも		"마치, 흡사"	
まるで		마치	
アタック		"어택, 공격, 도전"	
挑戦	ちょうせん	도전	
頭打ちになる	あたまうちになる	한계점에 이르다	
ピークに達する	ぴーくにたっする	절정에 달하다	
アチーブマント		"어치브먼트, 학습 성과, 학습 성적"	
達成	たっせい	달성	
あべこべ		"뒤바뀜, 반대"	
さかさま		거꾸로 됨	
アマチュア		아마추어	
あまねく		"널리, 골고루"	
あらまし		"개요, 대강, 대충"	
おおむね		"대개, 대략"	
ありありと		"뚜렷이, 선명히, 역력히"	
ありきたりの		"평범한, 흔해빠진"	
ありふれた		흔해빠진	
併せて・合わせて	あわせて	"합해서, 아울러, 함께"	
安直な	あんちょくな	"손쉬운, 간편한"	
簡易	かんい	간이	
言い合い	いいあい	"말다툼, 언쟁"	
口論・口げんか	こうろん・くちげんか	언쟁	
いかに		① 어떻게 ② 아무리 ③ 얼마나	
どのように		어떻게	
どんなに		아무리	
どれほど		얼마나	
いきさつ		"경위, (얽힌) 사정"	
憤る	いきどおる	"분개하다, 성내다, 노하다"	
いかる		분개하다	
憩い	いこい	"푹 쉼, 휴식"	
いじくる		만지작거리다	
いじける		"위축되다, 주눅이 들다"	
すくむ		움츠러지다	
頂	いただき	"(산 따위의) 꼭대기, 정상"	
山頂	さんちょう	산꼭대기	
いたって		"(지)극히, 매우, 대단히"	
一向に	いっこうに	전혀	
一切	いっさい	"① 일체, 모두 ② 일절, 전혀, 전연"	
いっそ		"도리어, 차라리"	
むしろ		차라리	
かえって		오히려	
偽り	いつわり	"거짓, 허위"	
ごまかす		속이다	
糸口	いとぐち	"실마리, 단서"	
手づる	てづる	"실마리, 단서"	
いとも		"매우, 아주"	
今となっては	いまとなっては	이제 와서	
今ひとつ	いまひとつ	"좀, 조금"	
きざ		아니꼬움	
いやみ		"빈정댐, 불쾌감"	
いらだつ		"초조하다, 애가 타다"	
あせる		초조하게 굴다	
じりじりする		"초조하다, 애가 타다"	
色合い	いろあい	색조	
トーン		"톤, 색조"	
色調	しきちょう	색조	
因業な	いんごうな	"완고한, 매정한, 냉혹한"	
無情な	むじょうな	"매정한, 무정한"	
インサート		"인서트, 삽입"	
挿入	そうにゅう	삽입	
インサイド		"인사이드, 안쪽 내부"	
裏側	うらがわ	안쪽	
インスピレーション		"인스피레이션, 영감"	
ひらめき		"번쩍 떠오름, 재치"	
インターナショナル		"인터내셔널, 국제적"	
国際的な	こくさいてきな	국제적인	
インフォメーション		"인포메이션, 접수처"	
受付	うけつけ	접수처	
ウェート・ウェイト		"무게, 중점"	
重点	じゅうてん	중점	
うかがう		"엿보다, 살피다, 노리다"	
受かる	うかる	"붙다, 합격하다"	
受け持ち	うけもち	"담임, 담당"	
担任	たんにん	담임	
打ち明ける	うちあける	"털어놓다, 고백하다"	
打ち込む	うちこむ	열중하다	
熱中する	ねっちゅうする	열중하다	
うつろ		(속이) 텅 빔	
疎ましい	うとましい	"싫다, 역겹다"	
うぬぼれる		"자만하다, 자부하다"	
思い上がる	おもいあがる	우쭐하다	
裏付け	うらづけ	"확실한 증거, 뒷증명"	
うろたえずに		당황하지 않고	
うんざりする		지긋지긋하다	
参る	まいる	"지치다, 질리다"	
前かけ	まえかけ	앞치마	
優雅な	ゆうがな	우아한	
高尚な	こうしょうな	고상한	
滑らかな	なめらかな	"원활한, 순조로운"	
スムーズに		순조롭게	
縁起	えんぎ	"(길흉의) 조짐, 재수"	
ジンクス		징크스	
先触れ	さきぶれ	"조짐, 징조"	
縁故	えんこ	"관계, 연줄"	
手づる	てづる	"연줄, 연고"	
つて		"연줄, 연고"	
コネ		"연줄, 연고"	
怨恨	えんこん	원한	
恨み	うらみ	원한	
エンターテインメント		"엔터테인먼트, 오락, 연예"	
娯楽	ごらく	오락	
芸能	げいのう	예능	
殴打する	おうだする	구타하다	
なぐる		때리다	
大方	おおかた	"거의, 대강"	
ほぼ		"거의, 대강"	
オートマチック		오토매틱	
自動的な	じどうてきな	자동적인	
往来	おうらい	"원래, 길(거리)"	
行き来	ゆきき	원래	
道路	どうろ	"도로, 길"	
おおまかに		"대략, 대충"	
おおざっぱに		대충	
幼稚な	ようちな	유치한	
収まる	おさまる	수습되다	
片付く	かたづく	해결되다	
解決する	かいけつする	해결되다	
おさらい		복습	
おっかない		"무섭다, 두렵다"	
おっくうな		귀찮은	
お手上げな		어찌할 도리가 없는	
乙女	おとめ	"소녀, 처녀"	
少女	しょうじょ	소녀	
処女	しょじょ	처녀	
自ずから	おのずから	"저절로, 자연히"	
おのずと		저절로	
ひとりでに		저절로	
自然に	しぜんに	저절로	
思う存分	おもうぞんぶん	"마음껏, 힘껏"	
思うまま	おもうまま	마음껏	
思い切り	おもいきり	마음껏	
趣	おもむき	"① 재미, 정취, 멋 ② 느낌, 모습, 분위기"	
味わい	あじわい	정취	
様子	ようす	모습	
面持ち	おももち	"표정, 안색"	
表情	ひょうじょう	"표정, 안색"	
顔つき	かおつき	"표정, 안색"	
思惑	おもわく	"생각, 의도"	
おろそかに		소홀히	
ぞんざいに		아무렇게나	
怨念	おんねん	"원념, 원한"	
ガードマン		"가드맨, 경비원"	
警備員	けいびいん	경비원	
解雇される	かいこされる	해고당하다	
首になる	くびになる	해고당하다	
振り返る	ふりかえる	회고하다	
回顧	かいこ	회고	
概して	がいして	대체로	
総じて	そうじて	대체로	
思い返す	おもいかえす	회상하다	
介抱	かいほう	"병구완, 간호"	
看病	かんびょう	간병	
カウンセラー		"카운셀러, 상담원"	
相談係	そうだんがかり	상담원	
面相	めんそう	용모	
抱え込む	かかえこむ	"끌어안다, 떠맡다"	
しょい込む	しょいこむ	떠맡다	
抱える	かかえる	"고용하다, 두다"	
雇う	やとう	고용하다	
愕然とする	がくぜんとする	깜짝 놀라다	
格段に	かくだんに	현격히	
格別に	かくべつに	"각별히, 특별히"	
とりわけ		특히	
かたくなな		"완고한, 고집스러운"	
強情な	ごうじょうな	고집이 센	
傍ら	かたわら	"옆, 가"	
わき		옆	
画期的な	かっきてきな	획기적인	
勝手	かって	부엌	
キッチン		부엌	
かつて		"① 일찍이, 전에 ② 전혀, 한 번도"	
葛藤	かっとう	"갈등, 분쟁"	
もめごと		분쟁	
かなた		"저쪽, 저편"	
向こうのほう	むこうのほう	저쪽	
奏でる	かなでる	"켜다, 연주하다"	
構え	かまえ	"(건물의) 외관, 구조, 태세, 준비"	
構造	こうぞう	구조	
ガレージ		차고	
車庫	しゃこ	차고	
かろうじて		"겨우, 간신히"	
代わる代わる	かわるがわる	"번갈아, 교대로"	
交互に	こうごに	번갈아	
玩具	がんぐ	"완구, 장난감"	
感触	かんしょく	감촉	
手ざわり	てざわり	감촉	
簡素な	かんそな	간소한	
単純な	たんじゅんな	단순한	
元来	がんらい	원래	
もともと		원래	
気掛かり	きがかり	"걱정, 근심, 염려"	
懸念	けねん	"걱정, 염려"	
気兼ね	きがね	"사양, 스스러움"	
危機	きき	위기	
ピンチ		"핀치, 위기"	
兆候	ちょうこう	징후	
きざな		"(언어 · 동작 등이) 같잖은, 아니꼬운"	
気丈夫な	きじょうぶな	마음이 든든한	
帰するところ	きするところ	결국	
つまるところ		결국	
つまり		결국	
毀損	きそん	"훼손, 파손"	
破損	はそん	파손	
鍛える	きたえる	"단련하다, 맹렬히 훈련하다"	
気立て	きだて	"심지, 마음씨"	
気前	きまえ	기질	
性質	せいしつ	성질	
脚本	きゃくほん	"각본, 대본"	
シナリオ		각본	
台本	だいほん	대본	
脚光	きゃっこう	각광	
フットライト		"푸트라이트, 각광"	
ギャップ		"갭, 틈새, 간격, 차이"	
溝	みぞ	"(의견, 감정 등의) 틈, 장벽"	
経歴	けいれき	경력	
恐慌	きょうこう	"공황, 두려워 당황함"	
パニック		패닉	
競走	きょうそう	경주	
仰天する	ぎょうてんする	깜짝 놀라다	
極力	きょくりょく	"극력, 힘껏"	
巨匠	きょしょう	"거장, (예술가의) 대가"	
大家	たいか	대가	
切り捨てる	きりすてる	잘라 버리다	
削減する	さくげんする	삭감하다	
亀裂	きれつ	"균열, 금"	
ひび		(잔)금	
極めて	きわめて	"극히, 매우, 더없이"	
食い足りない	くいたりない	만족하지 못하다	
クール		"쿨함, 냉정함"	
冷静な	れいせいな	냉정한	
くじける		"(기세가) 꺾이다, 좌절하다"	
ひるむ		(기세가) 꺾이다	
くじ引き	くじびき	"제비뽑기, 추첨"	
抽選	ちゅうせん	추첨	
朽ちる	くちる	"썩다, 쇠퇴하다"	
くさる		썩다	
屈指	くっし	굴지	
有数	ゆうすう	손꼽힘	
指折り	ゆびおり	손꼽힘	
くつろぐ		"편히 쉬다, 휴식하다"	
首飾り	くびかざり	목걸이	
ネックレス		목걸이	
工面	くめん	주머니 사정	
金回り	かねまわり	"돈의 유통, 주머니 사정"	
玄人	くろうと	"전문가, 숙련자"	
プロ		"전문가, 프로"	
企て	くわだて	"계획, 기도"	
ケア		"돌봄, 간호"	
経過	かいか	경과	
成行き	なりゆき	경과	
警戒	けいかい	경계	
用心	ようじん	"경계, 조심"	
恵沢	けいたく	"혜택, 은혜"	
恵み	めぐみ	은혜	
軽蔑する	けいべつする	경멸하다	
さげすむ		깔보다	
経路	けいろ	경로	
ルート		"루트, 경로"	
激励する	げきれいする	격려하다	
励ます	はげます	격려하다	
欠乏	けつぼう	결핍	
けなされる		"헐뜯기다, 욕을 먹다"	
堅実な	けんじつな	견실한	
しっかりした		야무진	
故意に	こいに	고의로	
厚顔な	こうがんな	낯두꺼운	
鉄面皮	てつめんぴ	철면피	
丹念に	たんねんに	세밀히	
まめに		꼼꼼히	
爽やかな	さわやかな	상쾌한	
すがすがしい		상쾌하다	
心得	こころえ	"마음가짐, 소양"	
心がけ	こころがけ	마음가짐	
心構え	こころがまえ	"마음의 준비, 각오"	
覚悟	かくご	각오	
心細い	こころぼそい	"어쩐지 마음이 불안하다, 허전하다"	
試み	こころみ	"시도(해 봄), 시험"	
試し	ためし	시도	
誤植	ごしょく	오식	
ミスプリント		미스 프린트	
こずえ		"나뭇가지 끝, 우듬지"	
枝の先	えだのさき	가지 끝	
誇張	こちょう	과장	
ことごとく		"전부, 모두, 모조리"	
こぞって		빠짐없이	
ことのほか		"대단히, 특별히, 유달리"	
拒む	こばむ	"거부하다, 응하지 않다"	
細やかに	こまやかに	자세히	
詳細に	しょうさいに	자세히	
コミッション		"커미션, 수수료"	
手数料	てすうりょう	수수료	
コメディー		코미디	
喜劇	きげき	희극	
暦	こよみ	달력	
カレンダー		달력	
コンディション		컨디션	
体調	たいちょう	"몸의 상태, 컨디션"	
コンテスト		"콘테스트, 경연 대회"	
競演会	きょうえんかい	경연 대회	
コンクール		"콩쿨, 경연 대회"	
コントラスト		"콘트라스트, 대조"	
遮る	さえぎる	"가리다, 막다, 차단하다"	
栄える	さかえる	"성해지다, 번영하다"	
繫盛する	はんじょうする	번창하다	
さしあたって		"지금, 당장, 당분간"	
さしあたり		당분간	
指図	さしず	"지시, 지휘"	
指揮	しき	지휘	
さぞ		"틀림없이, 필시, 아마"	
さぞや		틀림없이	
さぞかし		틀림없이	
定かな	さだかな	확실한	
錯覚	さっかく	착각	
ざっくばらんに		"솔직히, 탁 까놓고"	
さっと		"(비 · 바람이) 쏴, 획, 활짝"	
すばやく		재빠르게	
サポート		"서포트, 지지함, 원조함"	
バックアップ		백업(후원)	
援助	えんじょ	원조	
障る	さわる	"지장이 있다, 방해가 되다"	
さしつかえる		지장이 있다	
参上いたす	さんじょういたす	찾아뵙다	
シークレット		"시크릿, 기밀 비밀밀"	
仕返し	しかえし	"보복, 복수"	
報復	ほうふく	보복	
リベンジ		복수	
仕掛ける	しかける	① (싸움 등을) 걸다 ② 장치하다	
いどむ		(싸움을) 걸다	
セットする		설치하다	
しかるに		"그런데, 그럼에도 불구하고"	
ところが		그런데	
にもかかわらず		그럼에도 불구하고	
しきたり		"관례, 선례"	
ならわし		관례	
先例	せんれい	선례	
仕切る	しきる	"칸막이하다, 구획하다, 결산하다"	
決算する	けっさんする	결산을 하다	
仕草	しぐさ	"하는 짓, 태도, 몸짓"	
身ぶり	みぶり	몸짓	
しくじる		"실패하다, 실수하다"	
仕組む	しくむ	(몰래) 계획하다	
企む	たくらむ	계획하다	
したたか		"세게, 호되게"	
しぶとく		세게	
しなやかに		유연하게	
仕向ける	しむける	① 대우하다 ② 발송하다	
待遇する	たいぐうする	대우하다	
釈明	しゃくめい	"해명, 변명"	
弁明	べんめい	변명	
弁解	べんかい	변명	
わずか		조금	
いくらか		얼마간	
終生	しゅうせい	"종생, 일생 동안"	
これまで		지금까지	
種々	しゅじゅ	"갖가지, 여러 가지"	
もろもろ		여러 가지	
主将	しゅしょう	주장	
キャプテン		캡틴	
統率者	とうそつしゃ	통솔자	
巡回	じゅんかい	"순회, 순찰"	
パトロール		"패트롤, 순찰"	
照会	しょうかい	조회	
条理	じょうり	"조리, 도리"	
すじみち		"사리, 조리"	
触発される	しょくはつされる	자극받다	
所詮	しょせん	어차피	
どうせ		어차피	
所存	しょぞん	생각	
しょっちゅう		"늘, 언제나, 부단히"	
序論	じょろん	서론	
前置き	まえおき	서론	
退く	しりぞく	"(장소 · 지위에서) 물러나다, 물러서다, 후퇴하다"	
後退する	こうたいする	후퇴하다	
仕分ける	しわける	분류하다	
分類		분류	
真摯な	しんしな	진지한	
真剣な	しんけんな	진지한	
迅速に	じんそくに	신속하게	
速やかに	すみやかに	신속하게	
進捗する	しんちょくする	진척되다	
はかどる		진척되다	
衰退する	すいたいする	쇠퇴하다	
スケール		"규모, 도량"	
度量	どりょう	도량	
すこぶる		"매우, 대단히"	
はなはだ		매우	
健やかな	すこやかな	"건강한, 튼튼한"	
達者な	たっしゃな	건강한	
健全な	けんぜんな	건전한	
筋合い	すじあい	조리	
手続き	てつづき	절차	
素性	すじょう	"가문, 태생"	
生まれ	うまれ	태생	
スチーム		"스팀, 증기"	
蒸気	じょうき	증기	
ステップアップ		스텝 업	
進歩	しんぽ	진보	
向上	こうじょう	향상	
ストーリー		"스토리, 이야기"	
ストック		재고	
在庫	ざいこ	재고	
ストレートに		솔직하게	
すばしこい		"민첩하다, 잽싸다"	
素早い	すばやい	재빠르다	
スプリング		"스프링, 용수철"	
ぜんまい		"태엽, 용수철"	
すべ		"방법, 수단, 도리"	
スラックス		"슬랙스, 바지"	
ズボン		바지	
せかす・せかせる		"재촉하다, 서두르게 하다"	
急がせる	いそがせる	재촉하다	
セキュリティー		"시큐리티, 안전, 보안, 방범"	
保安	ほあん	보안	
防犯	ぼうはん	방범	
セクション		"섹션, 분할"	
部門	ぶもん	부문	
せっかち		성급함	
性急な	せいきゅうな	성급한	
接近	せっきん	접근	
アプローチ		접근	
折衝	せっしょう	절충(외교적 담판)	
話し合い	はなしあい	"의논, 교섭"	
絶頂	ぜっちょう	절정	
ピーク		절정	
セレモニー		"세레모니, 의식"	
儀式	ぎしき	의식	
せわしい		"바쁘다, 다망하다"	
多忙な	たぼうな	다망한	
慌ただしい	あわただしい	분주하다	
繊細な	せんさいな	섬세한	
デリケート		섬세함	
センス		"센스, 감각"	
先だって	せんだって	"앞서, 얼마전에, 요전에"	
このあいだ		요전에	
先方	せんぽう	"상대방, 상대편, 저쪽"	
旋律	せんりつ	선율	
メロディー		멜로디	
装飾	そうしょく	장식	
デコレーション		장식	
素描	そびょう	"소묘, 데생"	
デッサン		데생	
即日	そくじつ	"바로 그 날, 당일"	
当日	とうじつ	당일	
素振り	そぶり	"거동, 기색"	
大概	たいがい	"대개, 대강, 대체로"	
対抗	たいこう	대항	
立ち向かう	たちむかう	대항하다	
ターゲット		"타깃, 표적"	
的	まと	표적	
ダウンする		"떨어지다, 고장나서 작동하지 않다"	
蛇足	だそく	"사족, 군더더기, 쓸데없는 것"	
よけいなもの		쓸데없는 것	
立ち寄る	たちよる	"다가서다, 들르다"	
近寄る	ちかよる	다가가다	
訪れる	おとずれる	방문하다	
建前	たてまえ	"원칙, 방침"	
原則	げんそく	원칙	
だぶだぶ		(옷이) 헐렁헐렁	
ダメージ		"데미지, 손해, 타격"	
打撃	だげき	타격	
損害	そんがい	손해	
便り	たより	"소식, 편지"	
断じて	だんじて	"① 반드시, 꼭 ② 절대로"	
じっくりと		곰곰이	
段落	だんらく	단락	
胆力	たんりょく	담력	
度胸	どきょう	담력	
チャンピオン		"챔피언, 제1인자"	
第一人者	だいいちにんしゃ	제1인자	
治癒	ちゆ	"치유, 회복"	
注意深い	ちゅういぶかい	"매우 조심스럽다, 신중하다"	
中途半場	ちゅうとはんば	"흐지부지함, 어중간함"	
未完成	みかんせい	미완성	
中腹	ちゅうふく	산 중턱	
山腹	さんぷく	산의 중턱	
重宝する	ちょうほうする	쓸모가 있어 편리하다	
調和	ちょうわ	조화	
ハーモニー		조화	
賃貸	ちんたい	임대	
レンタル		렌탈	
ついては		"따라서, 그래서"	
したがって		따라서	
ついて(い)る		재수가 있다	
運がいい	うんがいい	운이 좋다	
月並み	つきなみ	"평범함, 진부함"	
償い	つぐない	"속죄, 보상"	
補償	ほしょう	보상	
繕う	つくろう	"고치다, 수선하다"	
修繕する	しゅうぜんする	수선하다	
告げる	つげる	"고하다, 알리다"	
知らせる	しらせる	알리다	
つつましい		조심스럽다	
控えめな	ひかえめな	조심스러운	
集い	つどい	"모임, 회합"	
会合	かいごう	회합	
集う	つどう	"모이다, 회합하다, 집회하다"	
募る	つのる	모집하다	
つぶさに		"자세히, 구체적으로"	
手薄	てうす	"허술함, 적음, 불충분함"	
不十分	ふじゅうぶん	불충분	
手頃な	てごろな	"알맞은, 적당한"	
適切な	てきせつな	적절한	
てっぺん		"꼭대기, 정상"	
手はず	てはず	"준비, 계획"	
手引き	てびき	"(손을 잡고) 인도함, 안내함, 첫걸음(책), 연줄"	
マニュアル		매뉴얼	
手分け	てわけ	분담	
てんで		"① 전혀, 아예, 도무지 ② 대단히, 매우"	
まるっきり		전혀	
まったく		전혀	
と		"얼핏, 언뜻, 잠깐"	
ふと		얼핏	
闘志	とうし	투지	
ファイト		투지	
意気込み	いきごみ	"패기, 의욕"	
当面ない	とうめんない	당분간 없다	
道理だ	どうりだ	"당연하다, 그럴 법하다"	
当たり前だ	あたりまえだ	당연하다	
独裁的	どくさいてき	독재적	
ワンマン		"원맨, 독재적인 사람"	
督促	とくそく	"독촉, 재촉"	
催促	さいそく	재촉	
土壇場	どたんば	"막판, 마지막 순간, 막다른 곳"	
窮地	きゅうち	궁지	
とっさに		순식간에	
瞬間的に	しゅんかんてきに	순간적으로	
どっさり		"듬뿍, 많이, 잔뜩"	
突如	とつじょ	"갑자기, 별안간"	
にわかに		"돌연, 갑자기"	
唱える	となえる	"주창하다, 주장하다"	
主唱する	しゅしょうする	주창하다	
主張する	しゅちょうする	주장하다	
途方もない	とほうもない	터무니없다	
戸惑う	とまどう	"망설이다, 당황하다"	
捉える	とらえる	"포착하다, 파악하다"	
取り去る	とりさる	"없애다, 제거하다"	
取り除く	とりのぞく	제거하다	
取りも直さず	とりもなおさず	"곧, 결국"	
すなわち		곧	
結局	けっきょく	결국	
頓着せずに	とんちゃくせずに	신경쓰지 말고	
おかまいなく		개의치 말고	
貪欲	どんよく	탐욕	
欲深	よくふか	"욕심이 많음, 과욕"	
なじむ		"익숙해지다, 친숙해지다"	
名だたる	なだたる	"유명한, 이름난"	
名高い	なだかい	유명한	
懐く	なつく	"따르다, 친해지다"	
馴れる	なれる	"따르다, 친숙해지다"	
なにかと		"이것저것, 여러가지로"	
何卒	なにとぞ	"제발, 부디, 아무쪼록"	
どうか		"부디, 아무쪼록"	
生温い	なまぬるい	"미적지근하다, 미온적이다"	
てぬるい		미온적이다	
波に乗る	なみにのる	시류에 편승하다	
時流に便乗する	じりゅうにびんじょうする	시류에 편승하다	
並びに	ならびに	"및, 또"	
および		"및, 또"	
かつ		"및, 또"	
軟弱な	なんじゃくな	연약한	
弱腰	よわごし	연약함	
賑わう	にぎわう	"활기차다, 번창하다"	
ネガ		"네거티브, 소극적, 부정적"	
否定的な	ひていてきな	부정적인	
ネック		"넥, 애로, 지장"	
支障	ししょう	지장	
粘り	ねばり	"찰기, 끈기"	
根気	こんき	끈기	
乗り越える	のりこえる	"뛰어넘다, 극복하다"	
順調に進む	じゅんちょうにすすむ	순조롭게 진행되다	
はかばかしい		"진척되다, 병이 호전되다"	
バック		"백, 배경, 후퇴, 후원자"	
後援者	こうえんしゃ	후원자	
抜群		발군	
ばてる		"지치다, 기진하다"	
バトル		"배틀, 싸움"	
たいそう		"대단히, 매우"	
張り合う	はりあう	경쟁하다	
競い合う	きそいあう	경쟁하다	
バロメーター		지표	
指標	しひょう	지표	
パワー		"파워, 힘, 능력"	
判じる・判ずる	はんじる・はんずる	판단하다	
見分ける	みわける	판별하다	
判明する	はんめいする	"판명되다, 밝혀지다"	
ひしと		"강렬하게, 매섭게"	
批評	ひひょう	비평	
コメント		코멘트	
百姓	ひゃくしょう	농민	
農民	のうみん	농민	
比喩	ひゆ	비유	
日和	ひより	"일기, (좋은) 날씨"	
晴天	せいてん	좋은 날씨	
びら		전단지	
ちらし		전단지	
翻す	ひるがえす	"뒤집다, 바꾸다"	
裏返す	うらがえす	뒤집다	
不意に	ふいに	"돌연히, 갑자기, 느닷없이"	
フォロー		"팔로우, 보조"	
補助	ほじょ	보조	
不器用な	ぶきような	"서투른, 손재주가 없는"	
無精・不精	ぶしょう	귀찮아 함	
面倒くさがり	めんどうくさがり	귀찮아 함	
付随・附随	ふずい	"부수, 연관"	
連関	れんかん	연관	
不用意	ふようい	부주의함	
ぶつかる		"부딪히다, 맞닥뜨리다, 마주치다"	
突き当たる	つきあたる	부딪히다	
巻き込まれる	まきこまれる	말려들다	
復帰	ふっき	복귀	
カムバック		복귀	
ふに落ちない	ふにおちない	납득이 가지 않다	
納得	なっとく	납득할 수 없다	
ふにゃふにゃ		부드러워 팽팽한 맛이 없는 모양	
フランク		솔직함	
ブランク		"블랭크, 여백, 공백"	
空白	くうはく	공백	
振り出し	ふりだし	"출발점, 처음 상태"	
出発点	しゅっぱつてん	출발점	
振る舞い	ふるまい	행동	
行動	こうどう	행동	
無礼	ぶれい	"무례, 실례"	
不遜	ふそん	무례	
プロセス		"프로세스, 절차, 경과, 과정"	
手続	てつづき	절차	
プロフィール		프로필	
横顔	よこがお	프로필	
略歴	りゃくれき	약력	
ふんだんに		"많이, 넉넉히"	
大量に	たいりょうに	대량으로	
並行	へいこう	병행	
両立	りょうりつ	양립	
同時進行	どうじしんこう	동시진행	
平生	へいぜい	평소	
平常	へいじょう	"보통, 평소"	
平素	へいそ	"보통, 평소"	
ふだん		"보통, 평소"	
へきえき		"손듦, 질림"	
閉口	へいこう	질림	
へま		실수	
ポーズ		"포즈, 자세"	
姿勢	しせい	자세	
保留する	ほりゅうする	보류하다	
見合わせる	みあわせる	보류하다	
本腰	ほんごし	"진지함, 본격적으로 임함"	
本気	ほんき	진지함	
前向き	まえむき	"적극적, 진취적"	
前もって	まえもって	"미리, 사전에"	
事前に	じぜんに	사전에	
まさしく		틀림없이	
まちまち		"갖가지, 각기 다름"	
マッチ		"매치, 어울림, 일치"	
一致	いっち	일치	
まなざし		"눈길, 시선"	
間々	まま	"가끔, 때때로"	
まばらだ		드문드문하다	
満遍なく	まんべんなく	"구석구석, 빠짐없이, 골고루"	
もれなく		빠짐없이	
あまねく		골고루	
見上げる	みあげる	감탄하다	
感心する	かんしんする	"감탄하다, 감동하다"	
ムード		"무드, 분위기, 기분"	
無性に	むしょうに	"몹시, 공연히, 무턱대고"	
むやみに		함부로	
やたらに		함부로	
無条件	むじょうけん	무조건	
文句なし	もんくなし	"완전히, 무조건"	
無造作に	むぞうさに	"손쉽게, 아무렇게나"	
無謀な	むぼうな	무모한	
無鉄砲	むてっぽう	무모함	
無論	むろん	물론	
目当て	めあて	"목적, 목표"	
めど		목표	
明瞭な	めいりょうな	명료한	
メンテナンス		"(건물 · 기계 등의) 관리, 유지"	
設ける	もうける	"마련하다, 베풀다, 설치하다"	
申し分	もうしぶん	"변명, 해명"	
毛頭	もうとう	"털 끝만큼도, 조금도, 전혀"	
目下	もっか	현재	
現在	げんざい	현재	
専ら	もっぱら	"오로지, 한결같이"	
ひたすら		한결같이	
弄ぶ	もてあそぶ	"가지고 놀다, 만지작거리다"	
もてる		인기가 있다	
物好き	ものずき	"유별난 것을 좋아함, 호기심"	
好奇心	こうきしん	호기심	
盛り上げる	もりあげる	분위기를 고조시키다	
活気づける	かっきづける	활기를 북돋우다	
もろに		"직접, 정면으로"	
まともに		직접적으로	
やきもち		"질투, 시기"	
ねたみ		"시기, 질투"	
嫉妬	しっと	질투	
やきもちをやく		질투하다	
ねたむ		"시기하다, 질투하다"	
やんちゃな		떼를 쓰는	
誘因	ゆういん	어떤 상태를 야기하는 원인	
優に	ゆうに	"족히, 충분히"	
ゆさぶる		(뒤)흔들다	
ゆるがす		(뒤)흔들다	
ユニーク		"유니크, 특이, 독특"	
独特な	どくとくな	독특한	
用心深い	ようじんぶかい	"신중하다, 조심성이 많다"	
用心棒	ようじんぼう	"경호원, 보디가드"	
ボディーガード		보디가드	
余地	よち	여지	
弱腰	よわごし	"소극적임, 저자세"	
弱虫	よわむし	겁쟁이	
いくじなし		겁쟁이	
弱る	よわる	"약해지다, 곤란해지다"	
ライバル		라이벌	
敵	てき	적	
がっかりする		실망하다	
立腹する	りっぷくする	역정내다	
リハーサル		"리허설, 예행연습"	
予行練習	よこうれんしゅう	예행연습	
リベート		"리베이트, 수수료"	
流暢な	りゅうちょうな	유창한	
了解	りょうかい	양해	
オーケー		오케이	
了承	りょうしょう	양해	
歴然としている	れきぜんとしている	분명하다	
はっきりしている		확실하다	
劣等感	れっとうかん	열등감	
朗報	ろうほう	낭보	
コンプレックス		콤플렉스	
知らせ	しらせ	소식	
浪漫的	ろうまんてき	낭만적	
和解	わかい	화해	
仲直り	なかなおり	화해	
煩わしい	わずらわしい	"귀찮다, 성가시다"	
あごを出す	あごをだす	몹시 지치다	
足が出る	あしがでる	"적자가 나다, 예산을 초과하다"	
肩を持つ	かたをもつ	편을 들다	
肩を並べる	かたをならべる	"어깨를 나란히 하다, 필적하다"	
気が済む	きがすむ	마음이 후련하다	
気に障る	きにさわる	비위에 거슬리다	
気を晴らす	きをはらす	우울한 기분을 풀다	
気をもむ	きをもむ	"마음을 졸이다, 애태우다"	
ぐっと来る	ぐっとくる	강한 감동을 느끼다	
さじを投げる	なじをなげる	가망이 없어 포기하다	
しのぎを削る	しのぎをけずる	맹렬히 싸우다	
そっぽを向く	そっぽをむく	"외면하다, 불응하다"	
手が出ない	てがでない	"어떻게 손을 쓸 수가 없다, 엄두가 안 난다"	
手を焼く	てをやく	"애먹다, 처치 곤란해하다"	
途方に暮れる	とほうにくれる	어찌할 바를 모르다	
長い目で見る	ながいめでみる	긴 안목으로 보다	
念のため	ねんのため	"만약을 위해, 혹시 몰라서"	
はっとする		깜짝 놀라다	
鼻にかける	はなにかける	"뽐내다, 자랑하다"	
腹が立つ	はらがたつ	화가 나다	
腹を決める	はらをきめる	"결심하다, 마음을 정하다"	
ほどがある		"한도가 있다, 유분수다"	
骨が折れる	ほねがおれる	"힘들다, 고생이 되다"	
目に見える	めにみえる	눈에 띄다	
目安をつける	めやすをつける	"대중을 잡다, 어림잡다"	
目を通す	めをとおす	"대강 훑어보다, 대충 보다"	
平行線をたどる	へいこうせんをたどる	평행선을 걷다	
まぎれもない		틀림없다	
もってのほか		당치도 않음	
焼け石に水	やけいしにみず	"언 발에 오줌 누기, 임시방편"	
躍起になる	やっきになる	기를 쓰다	
指を折る	ゆびをおる	손꼽아 헤아리다	
よしとする		"좋다고 치다, 잘된 것으로 인정하다"	
