合図	あいず	"(눈짓, 몸짓, 소리) 신호"
相手	あいて	상대
飽きる	あきる	"질리다, 싫증나다"
あくび		하품
預ける	あずける	맡기다
汗	あせ	땀
温める	あたためる	"따뜻하게 하다, 데우다"
当たる	あたる	맞다
厚い	あつい	두껍다
扱う	あつかう	취급하다
アドバイス		"충고, 어드바이스"
穴	あな	구멍
溢れる	あふれる	넘치다
余る	あまる	남다
編む	あむ	"엮다, 뜨다"
表す	あらわす	나타내다
現れる	あらわれる	나타나다
あわ		거품
合わせる	あわせる	"맞추다, (마음을) 합치다"
暗記	あんき	암기
意外に	いがいに	의외로
息	いき	숨
以降	いこう	이후
意志	いし	의지
位置	いち	위치
一般的な	いっぱんてきな	일반적인
移動	いどう	이동
イメージ		이미지
岩	いわ	바위
印象	いんしょう	인상
インタビュー		인터뷰
受け入れる	うけいれる	받아들이다
受け取る	うけとる	"수취하다, 받다"
右折	うせつ	우회전
内側	うちがわ	안쪽
うっかり		"무심코, 깜빡, 멍청히"
疑う	うたがう	의심하다
美しい	うつくしい	아름답다
移す	うつす	옮기다
移る	うつる	"옮기다, 이동하다"
埋める	うめる	"묻다, 메우다"
裏	うら	"뒤, 뒤쪽"
うろうろ		허둥지둥
うわさ		소문
影響	えいきょう	영향
栄養	えいよう	영양
笑顔	えがお	웃는 얼굴
エネルギー		에너지
延期	えんき	연기
演奏	えんそう	연주
追い付く	おいつく	따라잡다
追う	おう	"좇다, 뒤따르다"
横断	おうだん	횡단
応援	おうえん	응원
応募	おうぼ	응모
応用	おうよう	응용
オーバー		초과
おかしい		이상하다
惜しい	おしい	아깝다
お互いに	おたがいに	서로
落ち着く	おちつく	"가라앉다, 침착하다"
溺れる	おぼれる	빠지다
主に	おもに	주로
降りる	おりる	(탈것에서) 내리다
折る	おる	접다
折れる	おれる	"부러지다, 꺾이다"
温泉	おんせん	온천
カーブ		커브
解決	かいけつ	해결
改札	かいさつ	개찰(구)
回収	かいしゅう	회수
香り	かおり	향기
外食	がいしょく	외식
返す	かえす	"돌리다, 돌려주다"
替える	かえる	"바꾸다, 교환하다"
換える	かえる	"바꾸다, 교환하다"
価格	かかく	가격
かかる		(병에) 걸리다
かき混ぜる	かきまぜる	뒤섞다
各駅	かくえき	각 역
確実な	かくじつな	확실한
隠す	かくす	"감추다, 숨기다"
各地	かくち	각지
家具	かぐ	가구
過去	かこ	과거
囲む	かこむ	"둘러싸다, 에워싸다"
重ねる	かさねる	"겹치다, 포개다, 거듭하다"
貸す	かす	빌려주다
下線	かせん	밑줄
固い	かたい	"단단하다, 굳다"
片方	かたほう	"한 쪽, 한 짝"
カタログ		카탈로그
勝つ	かつ	이기다
がっかり		"실망, 낙담하는 모양"
楽器	がっき	악기
活動	かつどう	활동
悲しい	かなしい	슬프다
仮定	かてい	가정
必ず	かならず	반드시
カバー		덮개
我慢	がまん	참음
空	から	"빔, 공"
からから		바싹 마른 모양
がらがら		텅텅 빈 모양
借りる	かりる	빌리다
枯れる	かれる	"(식물이) 마르다, 시들다"
乾く	かわく	"마르다, 건조하다"
間隔	かんかく	간격
関係	かんけい	관계
観客	かんきゃく	관객
観光	かんこう	관광
観察	かんさつ	관찰
感じ	かんじ	느낌
関心	かんしん	관심
完成	かんせい	완성
乾燥	かんそう	건조
感動	かんどう	감동
気温	きおん	기온
機械	きかい	기계
期限	きげん	기한
傷	きず	"상처, 흠"
期待	きたい	기대
帰宅	きたく	귀가
汚い	きたない	더럽다
きつい		끼다
気づく	きづく	"알아채다, 깨닫다"
規則	きそく	규칙
記念	きねん	기념
希望	きぼう	희망
疑問	ぎもん	의문
逆	ぎゃく	"반대, 역"
キャンセル		취소
急	きゅう	"급함, 갑작스러움"
休日	きゅうじつ	휴일
教師	きょうし	교사
共通	きょうつう	공통
興味	きょうみ	흥미
協力	きょうりょく	협력
距離	きょり	거리
記録	きろく	기록
禁煙	きんえん	금연
緊張	きんちょう	긴장
空席	くうせき	공석
偶然	ぐうぜん	"우연히, 뜻밖에"
区切る	くぎる	"구분하다, 구획짓다"
くせ		"버릇, 습관"
配る	くばる	"분배하다, 배포하다"
区別	くべつ	구별
組む	くむ	"짜다, 끼다"
首	くび	목
悔しい	くやしい	분하다
苦しい	くるしい	"괴롭다, 난처하다"
苦労	くろう	고생
加える	くわえる	"더하다, 보태다"
暮らす	くらす	"살다, 생활하다, 지내다"
訓練	くんれん	훈련
経営	けいえい	경영
経営学	けいえいがく	경영학
計算	けいさん	계산
芸術	げいじゅつ	예술
経由	けいゆ	경유
外科	げか	외과
消す	けす	"(불, 전기 등을) 끄다"
血圧	けつあつ	혈압
血液	けつえき	혈액
血液型	けつえきがた	혈액형
欠席	けっせき	결석
欠点	けってん	결점
件	けん	"건, 사항"
券	けん	"권, 표"
原因	げんいん	원인
検査	けんさ	검사
健康	けんこう	건강
現在	げんざい	현재
減少	げんしょう	감소
建設	けんせつ	건설
建築	けんちく	건축
原料	げんりょう	원료
恋しい	こいしい	그립다
効果	こうか	효과
交換	こうかん	교환
合計	ごうけい	합계
広告	こうこく	광고
交流	こうりゅう	교류
呼吸	こきゅう	호흡
腰	こし	허리
個人	こじん	개인
断る	ことわる	거절하다
零す	こぼす	"흘리다, 엎지르다"
細かい	こまかい	"잘다, 작다"
困る	こまる	곤란하다
転ぶ	ころぶ	"넘어지다, 구르다"
～差	～さ	~차
最初	さいしょ	최초
最新	さいしん	최신
材料	ざいりょう	재료
坂道	さかみち	"비탈길, 언덕길"
盛んな	さかんな	번창한
雑誌	ざっし	잡지
さっそく		즉시
覚める	さめる	"깨다, 눈이 뜨이다"
～産	～さん	"(지역, 나라) ~산"
参加	さんか	참가
残業	ざんぎょう	잔업
塩	しお	소금
支給	しきゅう	지급
資源	しげん	자원
指示	しじ	지시
事情	じじょう	사정
自身	じしん	자신
沈む	しずむ	"가라앉다, 지다"
姿勢	しせい	자세
自然	しぜん	자연
親しい	したしい	친하다
しっかり		"꽉, 단단히"
失業	しつぎょう	"실업, 실직"
しつこい		끈질기다
実力	じつりょく	실력
自動的に	じどうてきに	자동적으로
しばらく		"한동안, 오랫동안"
縛る	しばる	묶다
絞る	しぼる	"짜다, 쥐어짜다"
島	しま	섬
しまう		"안에 넣다, 치우다"
自慢	じまん	자랑
染み	しみ	얼룩
締め切り	しめきり	마감
示す	しめす	"가리키다, 보이다, 나타내다"
知り合う	しりあう	서로 알게 되다
～者	～しゃ	~자
自由	じゆう	자유
週刊誌	しゅうかんし	주간지
就職	しゅうしょく	취직
渋滞	じゅうたい	"정체, 밀림"
重大	じゅうだい	중대함
集中	しゅうちゅう	집중
修理	しゅうり	수리
縮小	しゅくしょう	축소
手術	しゅじゅつ	수술
主張	しゅちょう	주장
出勤	しゅっきん	출근
出張	しゅっちょう	출장
首都	しゅと	수도
主要な	しゅような	주요한
種類	しゅるい	종류
順番	じゅんばん	"순번, 차례"
商業	しょうぎょう	상업
正直	しょうじき	정직함
乗車	じょうしゃ	승차
冗談	じょうだん	농담
消費	しょうひ	소비
商品	しょうひん	상품
上品な	じょうひんな	고상한
情報	じょうほう	정보
食器	しょっき	식기
信じる	しんじる	믿다
申請	しんせい	신청
新鮮	しんせん	신선함
身長	しんちょう	"신장, 키"
進歩	しんぽ	진보
ずいぶん		"꽤, 상당히"
頭痛	ずつう	두통
性格	せいかく	성격
制限	せいげん	제한
税金	ぜいきん	세금
清潔な	せいけつな	청결한
正常な	せいじょうな	"정상적인, 정상인"
成績	せいせき	성적
制服	せいふく	"제복, 교복"
整理	せいり	정리
席	せき	자리
積極的な	せっきょくてきな	적극적인
セット		"조절, 세트"
線	せん	선
全～	ぜん～	전~
前後	ぜんご	전후
選手	せんしゅ	선수
専門家	せんもんか	전문가
想像	そうぞう	상상
早退	そうたい	조퇴
相談	そうだん	"상담, 상의"
底	そこ	"바닥, 속"
育てる	そだてる	"키우다, 기르다"
そっくり		꼭 닮음
卒業	そつぎょう	졸업
そっと		살짝
そろそろ		이제 슬슬
退院	たいいん	퇴원
大会	たいかい	대회
代金	だいきん	대금
滞在	たいざい	"체재, 체류"
代表的な	だいひょうてきな	대표적인
大量	たいりょう	대량
体力	たいりょく	체력
確かに	たしかに	확실히
確かめる	たしかめる	확인하다
助ける	たすける	"돕다, 살리다, 구조하다"
戦う	たたかう	"싸우다, 전투하다"
畳む	たたむ	"접다, 개다"
経つ	たつ	"(시간, 세월이) 지나다"
他人	たにん	타인
たまる		쌓이다
ためる		(돈을) 모으다
頼る	たよる	의지하다
だるい		"나른하다, 지루하다"
チャレンジ		"도전, 챌린지"
中古	ちゅうこ	중고
調子	ちょうし	"상태, 컨디션"
中旬	ちゅうじゅん	중순
単語	たんご	단어
違う	ちがう	다르다
地球	ちきゅう	지구
駐車	ちゅうしゃ	주차
昼食	ちゅうしょく	"중식, 점심 식사"
調査	ちょうさ	조사
朝食	ちょうしょく	"조식, 아침 식사"
貯金	ちょきん	저금
直接	ちょくせつ	직접
通勤	つうきん	통근
通知	つうち	통지
通訳	つうやく	통역
疲れ	つかれ	피로
疲れる	つかれる	피곤하다
伝える	つたえる	전하다
伝わる	つたわる	"전해지다, 알려지다"
包む	つつむ	"싸다, 포장하다"
続き	つづき	"계속, 연결"
勤める	つとめる	근무하다
詰める	つめる	채워 넣다
到着	とうちゃく	도착
通り過ぎる	とおりすぎる	"지나가다, 통과하다"
得意な	とくいな	"자신이 있는, 잘하는"
伝言	でんごん	전언
停電	ていでん	정전
テーマ		테마
デザイン		디자인
動作	どうさ	동작
当日	とうじつ	당일
登場	とうじょう	등장
どきどき		"두근두근, 울렁울렁"
独身	どくしん	독신
特長	とくちょう	특장점
独立	どくりつ	독립
溶ける	とける	녹다
閉じる	とじる	"닫다, (눈을) 감다"
突然	とつぜん	돌연
怒鳴る	どなる	"고함치다, 호통치다"
飛ぶ	とぶ	날다
泊まる	とまる	"묵다, 숙박하다"
取り消す	とりけす	취소하다
努力	どりょく	노력
内緒	ないしょ	"비밀, 은밀"
内容	ないよう	내용
流れる	ながれる	흐르다
泣く	なく	울다
慰める	なぐさめる	"위로하다, 달래다"
投げる	なげる	던지다
なだらか		완만함
懐かしい	なつかしい	그립다
涙	なみだ	눈물
波	なみ	"파도, 물결"
なるべく		"가능한 한, 되도록"
似合う	にあう	"어울리다, 잘 맞다"
握る	にぎる	"쥐다, 장악하다"
逃げる	にげる	"도망치다, 달아나다"
荷物	にもつ	"짐, 화물"
根	ね	(식물) 뿌리
願う	ねがう	"바라다, 원하다"
熱心な	ねっしんな	열심인
眠る	ねむる	잠자다
農業	のうぎょう	농업
ノック		노크
延ばす	のばす	"연기하다, 연장하다"
葉	は	"잎, 잎사귀"
歯	は	"이, 이빨"
～倍	～ばい	~배
配達	はいたつ	배달
生える	はえる	"(풀, 이, 머리 등이) 나다"
測る	はかる	"재다, 달다"
バケツ		양동이
発見	はっけん	발견
発生	はっせい	발생
発展	はってん	발전
発表	はっぴょう	발표
話しかける	はなしかける	말을 걸다
離す	はなす	"떼다, 간격을 벌리다"
速く	はやく	빨리
早めに	はやめに	"빨리, 일찌감치"
払う	はらう	"내다, 지불하다"
半日	はんにち	"반일, 한나절"
パンプレット		"팜플렛, 소책자"
冷える	ひえる	"차가워지다, 식다"
比較	ひかく	비교
引き受ける	ひきうける	"(일, 역할을) 떠맡다"
低い	ひくい	낮다
ぴったり		딱 들어 맞음
表面	ひょうめん	표면
～秒	～びょう	~초
ヒント		힌트
不安	ふあん	불안
夫婦	ふうふ	부부
深い	ふかい	깊다
拭く	ふく	닦다
複雑な	ふくざつな	복잡하다
複習	ふくしゅう	복습
複数	ふくすう	복수
防ぐ	ふせぐ	"방어하다, 막다"
普通	ふつう	"보통, 대개"
物価	ぶっか	물가
打付ける	ぶつける	"부딪치다, 맞부딪치다"
沸騰	ふっとう	"끓어오름, 비등"
部分	ぶぶん	부분
不満	ふまん	불만
ふらふら		"비틀비틀, 휘청휘청"
ぶらぶら		"어슬렁어슬렁, 빈둥빈둥"
振る	ふる	흔들다
文章	ぶんしょう	문장
分類	ぶんるい	분휴
平均	へいきん	평균
平日	へいじつ	평일
別々	べつべつ	"따로따로, 각각"
ぺらぺら		"줄줄, 술술"
変化	へんか	변화
方角	ほうがく	"방위, 방향"
方向	ほうこう	방향
報告	ほうこく	보고
方法	ほうほう	방법
法律	ほうりつ	법률
訪問	ほうもん	방문
ほえる		짖다
募集	ぼしゅう	모집
干す	ほす	말리다
翻訳	ほんやく	번역
曲げる	まげる	"굽히다, 구부리다"
交ざる	まざる	섞이다
貧しい	まずしい	가난하다
混ぜる	まぜる	섞다
待ち合わせる	まちあわせ	만나기로 하다
マナー		매너
豆	まめ	콩
守る	まもる	"지키다, 보호하다"
迷う	まよう	"망설이다, (길을) 헤매다"
丸い	まるい	둥글다
回す	まわす	"돌리다, 회전시키다"
満員	まんいん	만원
満足	まんぞく	만족
見送る	みおくる	배웅하다
短い	みじかい	짧다
湖	みずうみ	호수
緑	みどり	녹색
身につける	みにつける	"익히다, 습득하다"
未来	みらい	미래
～向き	～むき	~향
剥く	むく	"벗기다, 까다"
結ぶ	むすぶ	"잇다, 매다, 묶다"
命令	めいれい	명령
面倒くさい	めんどうくさい	귀찮다
申込書	もうしこみしょ	신청서
燃える	もえる	타다
申し込み	もうしこみ	신청
目的	もくてき	목적
目標	もくひょう	목표
もったいない		아깝다
物語	ものがたり	이야기
文句	もんく	"불만, 불평"
焼く	やく	"굽다, 태우다"
訳する	やくする	번역하다
家賃	やちん	집세
薬局	やっきょく	약국
破れる	やぶれる	"찢어지다, 깨지다"
郵便	ゆうびん	우편
ユーモア		유머
床	ゆか	마루
行き先	ゆきさき	"행선지, 목적지"
輸出	ゆしゅつ	수출
ゆでる		"데치다, 삶다"
緩い	ゆるい	"느슨하다, 헐렁하다"
許す	ゆるす	"용서하다, 허락하다"
容器	ようき	"용기, 그릇"
横	よこ	"옆, 가로"
呼び掛ける	よびかける	호소하다
予約	よやく	예약
リサイクル		"리사이클, 재활용"
立派な	りっぱな	훌륭한
理由	りゆう	이유
流行	りゅうこう	유행
～料	～りょう	~료
両替	りょうがえ	환전
料金	りょうきん	요금
留守	るす	부재중
列	れつ	"열, 행렬"
若い	わかい	젊다
別れる	わかれる	"헤어지다, 작별하다"
分ける	わける	"나누다, 분배하다"
笑う	わらう	웃다
割合	わりあい	비율
割引	わりびき	할인
割れる	われる	"갈라지다, 깨지다"
