会う	あう	만나다
青い	あおい	파랗다
赤い	あかい	빨갛다
明るい	あかるい	밝다
上げる	あげる	"들다, 올리다"
あげる		주다
朝	あさ	아침
足	あし	발
明日	あした、あす	내일
遊ぶ	あそぶ	놀다
暖かい	あたたかい	따뜻하다
新しい	あたらしい	새롭다
後で	あとで	나중에
兄	あに	"형, 오빠"
アパート		아파트
浴びる	あびる	(샤워를) 하다
危ない	あぶない	위험하다
甘い	あまい	달다
雨	あめ	비
洗う	あらう	씻다
言う	いう	말하다
家	いえ	집
行く	いく	가다
いくら		얼마
医者	いしゃ	의사
忙しい	いそがしい	바쁘다
痛い	いたい	아프다
一度	いちど	한 번
一日	いちにち	하루
五日	いつか	5일
一週間	いっしゅうかん	1주일
五つ	いつつ	5개
一分	いっぷん	1분
犬	いぬ	개
入り口	いりぐち	입구
入れる	いれる	넣다
色々な	いろいろな	여러가지인
上	うえ	위
後ろ	うしろ	뒤
薄い	うすい	"얇다, 엷다, 얕다, 연하다"
生まれる	うまれる	태어나다
海	うみ	바다
売る	うる	팔다
うるさい	うるさい	시끄럽다
上着	うわぎ	상의
絵	え	그림
エアコン		에어컨
映画	えいが	영화
英語	えいご	영어
駅	えき	역
エレベーター		엘리베이터
円	えん	엔
鉛筆	えんぴつ	연필
おいしい		맛있다
多い	おおい	많다
大きい	おおきい	크다
大きな	おおきな	"큰, 커다란"
大勢	おおぜい	"많이, 많은 사람"
お母さん	おかあさん	어머니
お菓子	おかし	과자
お金	おかね	돈
起きる	おきる	일어나다
置く	おく	"놓다, 두다"
教える	おしえる	가르치다
おじさん		"삼촌, 아저씨"
押す	おす	누르다
遅い	おそい	"늦다, 느리다"
お父さん	おとうさん	아버지
男	おとこ	남자
男の子	おとこのこ	남자아이
男の人	おとこのひと	남자
一昨日	おととい	그저께
一昨年	おととし	재작년
大人	おとな	어른
同じ	おなじ	같은
お願いします	おねがいします	부탁합니다
お風呂	おふろ	목욕탕
覚える	おぼえる	외우다
重い	おもい	무겁다
面白い	おもしろい	재미있다
泳ぐ	およぐ	수영하다
下りる	おりる	내려가다
女	おんな	여자
女の子	おんなのこ	여자아이
女の人	おんなのひと	여자
～回	～かい	~회
～階	～かい	~층
外国	がいこく	외국
外国人	がいこくじん	외국인
会社	かいしゃ	회사
階段	かいだん	계단
買い物	かいもの	"쇼핑, 장보기"
買う	かう	사다
返る	かえる	반납하다
帰る	かえる	"돌아가다, 돌아오다"
かかる		"(시간, 돈 등이) 걸리다, 들다"
鍵	かぎ	열쇠
書く	かく	쓰다
かける		"걸다, (안경을) 쓰다"
風	かぜ	바람
風邪をひく	かぜをひく	감기에 걸리다
家族	かぞく	가족
学校	がっこう	학교
角	かど	모퉁이
かばん		가방
被る	かぶる	(모자를) 쓰다
カメラ		카메라
火曜日	かようび	화요일
辛い	からい	맵다
借りる	かりる	빌리다
軽い	かるい	가볍다
カレンダー		달력
川	かわ	강
簡単な	かんたんな	"간단한, 쉬운"
木	き	나무
消える	きえる	"꺼지다, 사라지다"
聞く	きく	"듣다, 묻다"
北	きた	북쪽
ギター		기타
北側	きたがわ	"북쪽, 북쪽 방면"
喫茶店	きっさてん	"찻집, 카페"
切手	きって	우표
切符	きっぷ	표
昨日	きのう	어제
90人	きゅうじゅうにん	90명
9000円	きゅうせんえん	9천엔
牛乳	ぎゅうにゅう	우유
9本	きゅうほん	9자루
教室	きょうしつ	교실
兄弟	きょうだい	형제
去年	きょねん	작년
切る	きる	자르다
きれいな		"깨끗한, 예쁜"
～キロ		~킬로(미터)
金曜日	きんようび	금요일
銀行	ぎんこう	은행
9月	くがつ	9월
9時	くじ	9시
9時半	くじはん	9시 반
果物	くだもの	과일
口	くち	입구
国	くに	"나라, 국가"
暗い	くらい	어둡다
グラム		그램
来る	くる	오다
車	くるま	차
黒い	くろい	검다
今朝	けさ	오늘 아침
消す	けす	"끄다, 없애다"
結構な	けっこうな	"충분한, 괜찮은"
結婚	けっこん	결혼
元気な	げんきな	건강한
～個	～こ	~개
公園	こうえん	공원
交差点	こうさてん	교차로
紅茶	こうちゃ	홍차
コーヒー		커피
5回	ごかい	5회
午後	ごご	오후
9つ	ここのつ	9개
午前中	ごぜんちゅう	오전 중
こちら		"이분, 이쪽"
こちらこそ		저야말로
ごちそうさま		잘 먹었습니다
今年	ことし	올해
子ども	こども	아이
ご飯	ごはん	밥
困る	こまる	"곤란하다, 난처하다"
5万	ごまん	5만
今月	こんげつ	이번 달
今週	こんしゅう	이번 주
財布	さいふ	지갑
魚	さかな	"물고기, 생선"
先	さき	"먼저, 앞"
咲く	さく	불다
さす		(우산을) 쓰다
～冊	～さつ	~권
雑誌	ざっし	잡지
砂糖	さとう	설탕
寒い	さむい	춥다
3000円	さんぜんえん	3천 엔
3600円	さんぜんろっぴゃくえん	3천 6백 엔
散歩	さんぽ	산책
30000円	さんまんえん	3만 엔
3分	さんぷん	3분
3本	さんぼん	3병
試合	しあい	시합
4月	しがつ	4월
時間	じかん	시간
仕事	しごと	"일, 업무"
静かな	しずかな	조용한
辞書	じしょ	사전
下	した	아래
したい		하고 싶다
7月	しちがつ	7월
7時	しちじ	7시
失礼します	しつれいします	실례합니다
自動車	じどうしゃ	자동차
閉まる	しまる	닫히다
閉める	しめる	닫다
写真	しゃしん	사진
写真を撮る	しゃしんをとる	사진을 찍다
シャツ		셔츠
シャワー		샤워
授業	じゅぎょう	수업
宿題	しゅくだい	숙제
上手な	じょうずな	"능숙한, 잘 하는"
丈夫な	じょうぶな	튼튼한
食堂	しょくどう	식당
知る	しる	알다
白い	しろい	하얗다
新聞	しんぶん	신문
スイッチ		스위치
水曜日	すいようび	수요일
吸う	すう	피우다
スカート		"스커트, 치마"
スキー		스키
好きな	すきな	좋아하는
少ない	すくない	적다
すぐに		바로
少し	すこし	조금
進む	すすむ	진행하다
ストーブ		"스토브, 난로"
スペイン		스페인
スポーツ		스포츠
住む	すむ	살다
セーター		스웨터
狭い	せまい	좁다
1000円	せんえん	1000엔
先月	せんげつ	지난달
先週	せんしゅう	지난주
掃除	そうじ	청소
先生	せんせい	선생님
全部	ぜんぶ	전부
外	そと	밖
側	そば	옆
祖父	そふ	"할아버지, 조부"
祖母	そぼ	"할머니, 조모"
空	そら	하늘
それでは		그럼
～代	～だい	~대
大学	だいがく	대학(교)
大丈夫な	だいじょうぶな	괜찮은
大切な	たいせつな	중요한
大抵	たいてい	대개
台所	だいどころ	부엌
大変な	たいへんな	힘든
高い	たかい	"높다, 비싸다"
たくさん		많이
タクシー		택시
出す	だす	"꺼내다, 부치다, 내다, 제출하다"
立つ	たつ	서다
建物	たてもの	건물
楽しい	たのしい	즐겁다
多分	たぶん	아마
食べ物	たべもの	"음식, 먹을 것"
食べる	たべる	먹다
誕生日	たんじょうび	생일
段々	だんだん	점점
小さい	ちいさい	작다
近い	ちかい	가깝다
違う	ちがう	"다르다, 틀리다"
近く	ちかく	근처
地図	ちず	지도
父	ちち	아버지
ちょうど		"마침, 꼭"
チョコレート		초콜릿
使う	つかう	"쓰다, 사용하다"
疲れる	つかれる	"피곤하다, 지치다"
付く	つく	켜지다
付ける	つける	켜다
詰まらない	つまらない	"재미없다, 시시하다"
冷たい	つめたい	차갑다
強い	つよい	강하다
手	て	손
テーブル		테이블
出かける	でかける	외출하다
手紙	てがみ	편지
デパート		백화점
でも		하지만
出る	でる	나가다
天気	てんき	날씨
電気	でんき	"전기, 불"
電車	でんしゃ	전철
電話	でんわ	전화
ドア		"문, 도어"
どういたしまして		천만의 말씀입니다
どうぞよろしく		잘 부탁합니다
動物	どうぶつ	동물
遠い	とおい	멀다
10日	とおか	10일
時々	ときどき	때때로
時計	とけい	시계
ところ		"곳, 장소"
図書館	としょかん	도서관
どちら		어느 쪽
隣	となり	"이웃, 옆"
飛ぶ	とぶ	날다
止まる	とまる	멈추다
友達	ともだち	친구
土曜日	どようび	토요일
取る	とる	"집다, 잡다"
ナイフ		"나이프, 칼"
中	なか	"안, 속, 중"
長い	ながい	길다
夏休み	なつやすみ	"여름 휴가, 여름 방학"
7000円	ななせんえん	7천 엔
70000円	ななまんえん	7만 엔
何語	なにご	어느 나라 말
7日	なのか	7일
名前	なまえ	이름
習う	ならう	배우다
並べる	ならべる	늘어놓다
何	なん・なに	무엇
何人	なんにん	몇 명
2回	にかい	2회
2階	にかい	2층
2冊	にさつ	2권
西	にし	서쪽
西側	にしがわ	"서쪽, 서쪽 방면"
2時間	にじかん	2시간
2時間半	にじかんはん	2시간 반
西口	にしぐち	서쪽 출입구
24時間	にじゅうよじかん	24시간
二百回	にひゃっかい	200회
日本語	にほんご	일본어
二万円	にまんえん	2만 엔
脱ぐ	ぬぐ	벗다
ネクタイ		넥타이
猫	ねこ	고양이
登る	のぼる	오르다
飲み物	のみもの	"음료, 마실 것"
飲む	のむ	마시다
乗る	のる	타다
歯	は	이
パーティー		파티
～杯	～はい	~잔
入る	はいる	들어가다
葉書	はがき	엽서
履く	はく	"(바지 등을) 입다, (신발을) 신다"
橋	はし	다리
初めて・始めて	はじめて	처음(으로)
初めに・始めに	はじめに	처음에
走る	はしる	달리다
バス		버스
二十歳	はたち	20살
働く	はたらく	일하다
八時	はちじ	8시
八万円	はちまんえん	8만 엔
花	はな	꽃
話	はなし	이야기
話す	はなす	이야기하다
バナナ		바나나
花見	はなみ	꽃구경
母	はは	어머니
早く	はやく	일찍
春	はる	봄
貼る	はる	붙이다
ハンカチ		손수건
半分	はんぶん	절반
ピアノ		피아노
東	ひがし	동쪽
東側	ひがしがわ	"동쪽, 동쪽 방면"
東口	ひがしぐち	동쪽 출입구
～匹	～ひき	~마리
弾く	ひく	"치다, 연주하다"
引く	ひく	"(감기에) 걸리다, 당기다, 끌다"
低い	ひくい	"낮다, (키가) 작다"
飛行機	ほこうき	비행기
暇	ひま	"시간, 틈"
左	ひだり	왼쪽
左側	ひだりがわ	좌측
人	ひと	사람
一つ	ひとつ	1개
一人	ひとり	1명
百	ひゃく	백(100)
百円	ひゃくえん	100엔
百人	ひゃくにん	100명
百本	ひゃっぽん	"100병, 100송이"
病院	びょういん	병원
病気	びょうき	병
広い	ひろい	넓다
プール		"수영장, 풀"
二つ	ふたつ	2개
二日	ふつか	2일
降る	ふる	"(눈, 비 등이) 내리다"
古い	ふるい	"낡다, 오래되다"
吹く	ふく	불다
ページ		페이지
下手な	へたな	"서투른, 잘 못하는"
便利な	べんりな	편리한
帽子	ぼうし	모자
ポケット		"포켓, 주머니"
欲しい	ほしい	"갖고 싶다, 원하다"
細い	ほそい	가늘다
ホテル		호텔
本	ほん	책
本屋	ほんや	"서점, 책방"
～枚	～まい	"~장, ~매"
毎朝	まいあさ	매일 아침
毎週	まいしゅう	매주
毎月	まいつき・まいげつ	매월
毎日	まいにち	매일
前	まえ	앞
曲がる	まがる	"돌다, 구부러지다"
また		"또, 다시"
まだ		아직
待つ	まつ	기다리다
まっすぐ		"곧장, 똑바로"
窓		"창, 창문"
磨く	みがく	닦다
蜜柑	みかん	귤
右	みぎ	오른쪽
短い	みじかい	짧다
水	みず	물
店	みせ	가게
見せる	みせる	보여주다
道	みち	길다
三つ目	みっつめ	세 번째
南	みなみ	남쪽
耳	みみ	귀
見る	みる	보다
六日	むいか	6일
六つ	むっつ	6개
目	め	눈
メートル		미터
もうすぐ		"머지않아, 이제 곧"
木曜日	もくようび	목요일
勿論	もちろん	물론
持つ	もつ	"가지다, 들다"
もっと		더
もらう		받다
野菜	やさい	채소
安い	やすい	싸다
休み	やすみ	"휴일, 방학"
休む	やすむ	쉬다
八つ	やっつ	8개
山	やま	산
郵便局	ゆうびんきょく	우체국
夕べ	ゆうべ	어젯밤
有名な	ゆうめいな	유명한
雪	ゆき	눈
ゆっくり		"천천히, 푹"
八日	ようか	8일
よく		"잘, 자주"
四人	よにん	4명
呼ぶ	よぶ	부르다
読む	よむ	읽다
夜	よる	밤
よろしく		잘 부탁해
弱い	よわい	약하다
四キロ	よんきろ	4킬로(미터)
ラーメン		라멘
来月	らいげつ	다음 달
来週	らいしゅう	다음 주
来年	らいねん	내년
ラジオ		라디오
立派な	りっぱな	훌륭하다
留学生	りゅうがくせい	유학생
料理	りょうり	요리
旅行	りょこう	여행
りんご		사과
冷蔵庫	れいぞうこ	냉장고
レストラン		레스토랑
練習	れんしゅう	연습
六時	ろくじ	6시
六千円	ろくせんえん	6천 엔
六年間	ろくねんかん	6년간
六本	ろっぽん	6분
ワイシャツ		와이셔츠
若い	わかい	젊다
忘れる	わすれる	"잊어버리다, 잊고 두고 오다"
渡す	わたす	"건네다, 주다"
渡る	わたる	건너다
悪い	わるい	나쁘다
