騒然とする	そうぜんとする	시끄럽다
諭す	さとす	잘 타이르다
秩序	ちつじょ	질서
潜伏	せんぷく	잠복
朗らかな	ほがらかな	명랑한
振興	しんこう	진흥
軌跡	きせき	궤적
偏り	かたより	"편견, 치우침"
矛盾	むじゅん	모순
誇張	こちょう	과장
賄う	まかなう	"식사를 제공하다, 꾸려 나가다"
軽率な	けいそつな	경솔한
勇敢に	ゆうかんに	용감하게
忠告	ちゅうこく	충고
慕う	したう	"경모하다, 깊이 존경하다"
施錠	せじょう	자물쇠를 채움
沈下	ちんか	"침하, 물속에 가라앉음"
阻まれる	はばまれる	가로막히다
監督	かんとく	감독
派生	はせい	파생
透ける	すける	"비쳐 보이다, 들여다 보이다"
恩恵	おんけい	은혜
臨む	のぞむ	임하다
如実に	にょじつに	"여실히, 있는 그대로"
錯覚	さっかく	착각
尊い	とうとい	"소중하다, 귀중하다"
枯渇	こかつ	고갈
慰める	なぐさめる	"달래다, 위로하다"
克明に	こくめいに	극명하게
緊迫した	きんぱくした	긴박한
遺憾	いかん	유감
閉鎖	へいさ	폐쇄
心遣い	こころづかい	"마음을 씀, 걱정함, 배려"
憤る	いきどおる	"분개하다, 성내다"
貧富	ひんぷ	빈부
治癒	ちゆ	치유
干渉	かんしょう	간섭
粘る	ねばる	끈덕지게 버티다
巧妙	こうみょう	교묘함
促す	うながす	"재촉하다, 촉구하다"
措置	そち	조치
猛烈	もうれつ	맹렬함
克服	こくふく	극복
崩れやすい	くずれやすい	무너지기 쉽다
繫殖	はんしょく	번식
履歴	りれき	이력
映える	はえる	"빛나다, 비치다"
披露	ひろう	"피로, 공표함"
砕ける	くだける	"부서지다, 깨지다"
執着	しゅうちゃく	집착
債務	さいむ	채무
貢献	こうけん	공헌
潔い	いさぎよい	"떳떳하다, (미련없이) 깨끗하다"
回顧	かいこ	"회고, 회상"
偽り	いつわり	거짓
嫌悪感	けんおかん	혐오감
自粛	じしゅく	"자숙, 자제"
戒める	いましめる	"훈계하다, 제지하다, 징계하다"
丘陵	きゅうりょう	"구릉, 언덕"
豪快	ごうかい	호쾌함
忍耐	にんたい	인내
募る	つのる	"① 모집하다, 모으다 ② 점점 심해지다"
膨大	ぼうだい	방대함
滞る	とどこおる	"정체되다, 막히다, 밀리다"
驚嘆	きょうたん	경탄(놀라며 감탄함)
潤す	うるおす	① 축이다 ② 윤택하게 하다
殺菌	さっきん	살균
託される	たくされる	맡겨지다
傾斜する	けいしゃする	경사지다
暴露	ばくろ	폭로
開拓	かいたく	개척
復興	ふっこう	부흥
怠る	おこたる	게을리하다
了承	りょうしょう	"승낙, 납득, 양해"
指図	さしず	"지시, 지휘"
巡り	めぐり	"한바퀴 돎, 여기저기 들름"
樹木	じゅもく	수목
蓄える	たくわえる	"대비해 두다, 저장하다"
陳列	ちんれつ	진열
華やかな	はなやかな	화려한
鑑定	かんてい	(미술품 등의) 감정
偏る	かたよる	"치우치다, 기울다"
人脈	じんみゃく	인맥
顕著に	けんちょに	현저하게
多岐にわたる	たきにわたる	여러 갈래에 걸치다
廃れる	すたれる	"쇠퇴하다, 유행하지 않게 되다"
相場	そうば	시세
興奮	こうふん	흥분
唱える	となえる	"외치다, 주장하다"
変遷	へんせん	변천
値する	あたいする	"가치가 있다, ~할 만하다"
随時	ずいじ	"수시, 그때그때"
励む	はげむ	"힘쓰다, 노력하다"
添付	てんぷ	첨부
慕われる	したわれる	"존경받다, 사랑받다"
破損	はそん	파손
承諾	しょうだく	승낙
淡い	あわい	"(맛, 빛깔) 진하지 않다"
画一的	かくいつてき	획일적
概略	がいりゃく	"개략, 대략"
臨む	のぞむ	임하다
督促	とくそく	독촉
漂う	ただよう	"떠돌다, 표류하다"
厳正	げんせい	엄정함
拒む	こばむ	거부하다
躍進	やくしん	약진(눈부시게 진출함)
遂行	すいこう	"(계획, 책임 등) 수행"
凝縮	ぎょうしゅく	"응축, 응결"
健やかな	すこやかな	"튼튼한, 건강한"
中枢	ちゅうすう	중추
否めない	いなめない	부정할 수 없다
把握	はあく	파악
憤り	いきどおり	분노
趣旨	しゅし	취지
日夜	にちや	"① 밤낮 ② 언제나, 늘"
貫く	つらぬく	"관철하다, 관통하다"
貧富	ひんぷ	빈부
愚かな	おろかな	어리석은
巧妙な	こうみょうな	교묘한
憩い	いこい	휴식
需要	じゅよう	수요
緩和	かんわ	완화
跡地	あとち	"철거부지, 잔해"
枠	わく	테두리
網羅	もうら	망라
名誉	めいよ	명예
費やす	ついやす	소비하다
由緒	ゆいしょ	유서
手際	てぎわ	"솜씨, 수완"
群衆	ぐんしゅう	군중
覆す	くつがえす	뒤엎다
心地よい	ここちよい	"기분이 좋다, 상쾌하다"
改革	かいかく	개혁
克明	こくめい	① 자세하고 꼼꼼함 ② 성실하고 정직함
踏襲する	とうしゅうする	"답습하다, 전철을 밟다"
鈍る	にぶる	둔해지다
漠然と	ばくぜんと	막연히
閲覧	えつらん	열람
釈明	しゃくめい	"변명, 해명"
兆し	きざし	"조짐, 징조"
合併	がっぺい	합병
利益	りえき	이익
逃れる	のがれる	"벗어나다, 면하다"
考慮	こうりょ	고려
遮る	さえぎる	"가로막다, 차단하다"
根拠	こんきょ	근거
肝心	かんじん	중요함
本筋	ほんすじ	본론
伴奏	ばんそう	반주
推理	すいり	추리
極める	きわめる	"더없이 ~하다, 다하다"
練る	ねる	"① 반죽하다 ② (계획, 구상) 짜다 ③ (초안) 가다듬다"
締める	しめる	"① (끈 등으로) 매다 ② 죄다, 잠그다"
契約	けいやく	계약
潤う	うるおう	① 축축해지다 ② 혜택을 받다
手薄な	てうすな	"허술한, 불충분한"
壊す	こわす	"부수다, 고장내다"
華々しい	はなばなしい	화려하다
危ぶむ	あやぶむ	"의심하다, 걱정하다"
意義	いぎ	의의
至る	いたる	"이르다, 닥치다"
挑む	いどむ	도전하다
促す	うながす	"재촉하다, 촉구하다"
円滑な	えんかつな	원활한
演奏	えんそう	연주
大幅な	おおはばな	대폭적인
丘	おか	언덕
惜しむ	おしむ	"아끼다, 아쉬워하다"
襲う	おそう	"덮치다, 습격하다"
穏やかな	おだやかな	온화한
訪れ	おとずれ	"방문, 소식"
貝殻	かいがら	조개껍데기
海峡	かいきょう	해협
介護	かいご	간호
怪獣	かいじゅう	괴수
開拓	かいたく	개척
輝く	かがやく	빛나다
垣根	かきね	"울타리, (비유적으로) 장벽"
架空	かくう	가공
各種	かくしゅ	각종
駆ける	かける	"달리다, 뛰다"
火災	かさい	화재
稼ぐ	かせぐ	(돈을) 벌다
花壇	かだん	화단
頑丈	がんじょう	튼튼함
監督	かんとく	감독
企業	きぎょう	기업
戯曲	ぎきょく	희곡
既婚者	きこんしゃ	기혼자
厳しい	きびしい	"엄하다, 심하다"
寄附	きふ	기부
脚本	きゃくほん	"각본, 대본"
拒否	きょひ	거부
吟味	ぎんみ	"음미, 검토, 잘 조사하여 고름"
崩す	くずす	"무너뜨리다, 흩뜨리다"
工夫	くふう	"궁리, 고안"
詳しい	くわしい	"상세하다, 자세하다"
経緯	けいい	경위
欠陥	けっかん	결함
賢明な	けんめいな	현명한
行為	こうい	행위
香辛料	こうしんりょう	향신료
強盗	ごうとう	강도
考慮	こうりょ	고려
快い	こころよい	"기분이 좋다, 상쾌하다"
小銭	こぜに	잔돈
献立	こんだて	"식단, 메뉴"
遮る	さえぎる	"가로막다, 차단하다"
裂く	さく	"찢다, 가르다"
削減	さくげん	삭감
避ける	さける	피하다
寂しい	さびしい	쓸쓸하다
色彩	しきさい	"① 색채 ② 특색, 경향"
自己	じこ	자기
姿勢	しせい	자세
施設	しせつ	시설
慕う	したう	"그리워하다, 연모하다"
実費	じっぴ	실비
執筆	しっぴつ	집필
芝居	しばい	"연극, 연기"
斜面	しゃめん	경사면
収益	しゅうえき	수익
終始	しゅうし	"시종, 줄곧, 내내"
柔軟な	じゅうなんな	유연한
祝賀会	しゅくがかい	축하 모임
修行	しゅぎょう	"수행, 불도를 닦음"
首相	しゅしょう	수상
奨励	しょうれい	장려
人材	じんざい	인재
真珠	しんじゅ	진주
迅速な	じんそくな	신속한
慎重な	しんちょうな	신중한
辛抱	しんぼう	"참음, 인내"
勧める	すすめる	권하다
澄む	すむ	"맑다, 맑아지다"
盛大な	せいだいな	성대한
是正	ぜせい	시정
折衷	せっちゅう	절충
迫る	せまる	① (시각) 다가오다 ② (상태) 직면하다
添える	そえる	"첨부하다, 곁들이다"
素材	そざい	소재
阻止	そし	저지
訴訟	そしょう	소송
措置	そち	"조치, 조처"
率先	そっせん	솔선
妥協	だきょう	타협
漂う	ただよう	"떠돌다, 감돌다"
脱する	だっする	벗어나다
中旬	ちゅうじゅん	중순
彫刻	ちょうこく	조각
徴収	ちょうしゅう	징수
沈黙	ちんもく	침묵
尽くす	つくす	"다하다, 애쓰다"
償い	つぐない	"보상, 속죄"
努めて	つとめて	"애써, 되도록"
募る	つのる	① 모집하다 ② 점점 심해지다
邸宅	ていたく	저택
哲也	てつや	철야
転換	てんかん	전환
典型	てんけい	전형
陶器	とうき	"도기, 도자기"
隣	となり	이웃
問屋	とんや	도매상
苗	なえ	모종
眺める	ながめる	"바라보다, 멀리보다"
嘆く	なげく	탄식하다
倣う	ならう	"모방하다, 따르다"
認識	にんしき	인식
縫う	ぬう	꿰매다
臨む	のぞむ	"임하다, 당면하다"
把握	はあく	파악
端	はし	"끝, 가장자리"
鉢	はち	"화분, 사발"
華やかな	はなやかな	화려한
浜辺	はまべ	바닷가
反射	はんしゃ	반사
悲惨な	ひさんな	비참한
人影	ひとかげ	"사람의 그림자, 인적"
人柄	ひとがら	인품
人質	ひとじち	인질
侮辱	ぶじょく	모욕
再び	ふたたび	"재차, 다시"
復興	ふっこう	부흥
赴任	ふにん	부임
腐敗	ふはい	부패
不平等	ふびょうどう	불평등
踏み場	ふみば	발 디딜 곳
閉鎖	へいさ	폐쇄
別荘	べっそう	별장
返済	へんさい	"반제, (빚을) 갚음"
奉仕	ほうし	봉사
飽和	ほうわ	포화
朗らかな	ほがらかな	명랑한
墓地	ぼち	묘지
滅ぶ	ほろぶ	"멸망하다, 쇠퇴하다"
本場	ほんば	본고장
賄う	まかなう	"조달하다, 마련하다"
紛らわしい	まぎらわしい	헷갈리기 쉽다
無言	むごん	"무언, 말이 없음"
巡る	めぐる	"둘러싸다, 돌다, 돌아다니다"
催す	もよおす	"개최하다, 열다"
融通	ゆうずう	① (돈의) 융통 ② 융통성
夕闇	ゆうやみ	"땅거미, 황혼"
幽霊	ゆうれい	유령
寮	りょう	기숙사
類似	るいじ	"유사, 비슷함"
連日	れんじつ	"연일, 매일"
廊下	ろうか	복도
老衰	ろうすい	노쇠
枠内	わくない	"테두리 안, 범위 내"
自立	じりつ	자립
還元	かんげん	환원
どんよりと		잔뜩
ネック		걸림돌 (이 되다)
発散	はっさん	발산
紛らわしい	まぎらわしい	혼동하기 쉽다
行き届く	ゆきとどく	① 자상하다 ② (청소 등이) 빈틈 없다
快挙	かいきょ	쾌거
助長	じょちょう	(혼란 등을) 조장
見返り	みかえり	"대가, 보상"
結成	けっせい	결성
手配	てはい	"① 수배 ② (출장 등의) 준비, 절차"
つくづく		절실히
ほぐれる		(긴장 등이) 풀리다
軽快な	けいかいな	경쾌한
サイクル		사이클
仲裁	ちゅうさい	중재
しわざ		"짓, 소행"
発覚	はっかく	발각
すべすべ		매끈매끈
かみ合う	かみあう	"맞물리다, (의견 등이) 서로 맞다"
保護	ほご	보호
忠実に	ちゅうじつに	충실히
すくう		"떠내다, 건져 올리다"
念願	ねんがん	염원
ピント		"핀트, 초점"
食い込む	くいこむ	"파고들다, 차지하다"
てっきり		틀림없이
存続	そんぞく	존속
派	は	"파, 파벌"
熟知	じゅくち	숙지
風習	ふうしゅう	풍습
もどかしい		"애가 타다, 안타깝다"
めきめき		눈에 띄게
こじれる		"복잡해지다, 뒤틀리다"
却下	きゃっか	"각하, 기각"
旺盛	おうせい	왕성
目先	めさき	"눈앞, 현재, 당장"
施す	ほどこす	"행하다, 가공(장식)하다"
余波	よは	여파
担う	になう	짊어지다
ぎくしゃくする		"(관계가) 서먹서먹하다, 껄끄럽다"
クレーム		"클레임, 불만"
壮大な	そうだいな	장대한
経緯	けいい	경위
みっちり		착실히
撤去	てっきょ	철거
危ぶまれる	あやぶまれる	의심스럽다
うずうずする		"(몸이) 근질근질하다, 좀이 쑤시다"
センサー		센서
心地よい	ここちよい	기분이 좋다
従事	じゅうじ	종사
にじむ		번지다
禁物	きんもつ	금물
ひしひしと		절실히
表明	ひょうめい	표명
精力的に	せいりょくてきに	정력적으로
気掛かり	きがかり	"걱정, 마음에 걸림"
推移	すいい	추이
ずっしり		무거운 모양
歴然	れきぜん	"(차이, 증거 등이) 분명함, 뚜렷함"
在庫	ざいこ	재고
リスク		"리스크, 위험"
堅実な	けんじつな	건실한
遮断	しゃだん	차단
がらりと		싹 (갑자기 변하는 모양)
なだめる		달래다
言及	げんきゅう	언급
解除	かいじょ	해제
レイアウト		레이아웃
起用	きよう	기용
駆けつける	かけつける	급히 달려가다
多角的な	たかくてきな	다각적인
盛大な	せいだいな	성대한
せかせかと		부산하게
一環	いっかん	일환
コンスタントに		꾸준히
よみがえる		되살아나다
たたえる		"칭찬하다, 기리다"
非	ひ	잘못
もっぱら		오로지
シェア		"점유율, 지분"
打診	だしん	타진
経歴	けいれき	경력
はじく		"튕기다, 튀기다"
逸脱	いつだつ	"일탈, 벗어남"
いとも		아주
まちまち		"제각각, 가지각색"
教訓	きょうくん	교훈
センス		센스
流出	りゅうしゅつ	유출
頻繫に	ひんぱんに	빈번하게
切り出す	きりだす	"꺼내다, 시작하다"
へとへと		지쳐서 힘이 없는 모양
基盤	きばん	기반
見かける	みかける	"언뜻 보다, 만나다"
すんなり		일이 저항 없이 잘 되는 모양
一掃	いっそう	"일소, 남김없이 제거함"
染みる	しみる	배다
愛着	あいちゃく	애착
ノウハウ		노하우
稼働	かどう	가동
すさまじい		굉장한
直面	ちょくめん	직면
しいと		굳이
くよくよ		끙끙
該当	がいとう	해당
紛れる	まぎれる	뒤섞이다
合意	ごうい	합의
メディア		"미디어, 매체"
強制	きょうせい	"강제, 강요"
おおらかな		대범한
幅広い	はばひろい	폭넓은
起伏	きふく	기복
取り戻す	とりもどす	되찾다
支障	ししょう	지장
おびただしい		엄청난
平行線をたどる	へいこうせんをたどる	"평행선을 걷다, 의견일치를 못보다"
てきぱき		척척
ウエイト		"무게, 중점"
予断	よだん	"예측, 예단"
可決	かけつ	가결
心細い	こころぼそい	불안한
食い止める	くいとめる	저지하다
ノルマ		할당량
異色	いしょく	이색
揺らぐ	ゆらぐ	"흔들리다, 동요하다"
駆使する	くしする	구사하다
立て替える	たてかえる	(비용을) 대신 치르다
一任する	いちにんする	일임하다
むしょうに		몹시
強硬に	きょうこうに	강경하게
荷	に	"짐, 책임"
障る	さわる	거슬리다
じめじめする		눅눅하다
念頭	ねんとう	염두
とりわけ		특히
そわそわ		안절부절
腕前	うでまえ	솜씨
ためらう		주저하다
ハードル		"기준, 허들"
大筋	おおすじ	"대강, 대략, 요점"
版	ぱん	"판, 인쇄판"
究明する	きゅうめいする	규명하다
急遽	きゅうきょ	갑작스럽게
言い張る	いいはる	우기다
寄与する	きよする	기여하다
人出	ひとで	인파
和らぐ	やわらぐ	누그러지다
リストアップする		열거하다
まみれ		투성이
弾む	はずむ	활기를 띠다
実情	じつじょう	실정
逸材	いつざい	(뛰어난) 인재
不備がある	ふびがある	"준비가 되지 않았다, 갖추어지지 않았다"
修復	しゅうふく	"복원, 수복"
強み	つよみ	"강점, 장점"
猛反対	もうはんたい	맹반대
無謀な	むぼうな	무모한
会心の	かいしんの	"회심의, 마음에 드는"
ニュアンス		뉘앙스
並行して	へいこうして	나란히
抜粋	ばっすい	발췌
ストック		재고
完結する	かんけつする	완결되다
フォローする		"지원하다, 보조하다"
本音	ほんね	본심
やんわり		완곡하게
当	とう	"당, 저희"
綿密な	めんみつな	면밀한
報じる	ほうじる	보도하다
及ぼす	およぼす	미치다
キャリア		경력
結束	けっそく	결속
背景	はいけい	배경
愛想	あいそ	붙임성
あえて		"감히, 굳이"
明かす	あかす	"밝히다, 털어놓다"
あっさり		"간단히, 깨끗이"
圧迫	あっぱく	압박
あやふや		"불확실함, 모호함"
誤る	あやまる	"실수하다, 잘못하다"
あらかじめ		"미리, 사전에"
ありのままに		있는 그대로
安静	あんせい	안정
いじる		만지작거리다
一連	いちれん	① 일련 ② 일행
一挙に	いっきょに	"일거에, 단숨에"
意図	いと	의도
いやらしい		불쾌하다
意欲	いよく	의욕
ウイルス		바이러스
うぬぼれる		자만하다
うっとうしい		① (기분 · 날씨) 울적하고 답답하다 ② 귀찮다
閲覧室	えつらんしつ	열람실
負う	おう	"짊어지다, 혜택을 입다"
大げさな	おおげさな	"과장된, 야단스러운"
おどおど		"쭈뼛쭈뼛, 벌벌"
オーバー		"오버, 초과"
おろか		어리석음
おろそか		소홀함
回収	かいしゅう	회수
改修	かいしゅう	"개수, 수리"
概説	がいせつ	개설
介入	かいにゅう	개입
革新	かくしん	혁신
過疎	かそ	"과소, 지나치게 드묾"
かつ		"동시에, 한편"
頑固な	がんこな	완고한
肝心な	かんじんな	"중요한, 요긴한"
カンニング		커닝
危害	きがい	위해
規格	きかく	규격
きっちり		꼭 맞는 모양
きっぱり		"딱 잘라, 단호하게"
規範	きはん	규범
気品	きひん	기품
興じる	きょうじる	"즐기다, 흥겨워하다"
覆す	くつがえす	뒤엎다
形勢	けいせい	형세
けなす		"혹평하다, 헐뜯다"
煙たい	けむたい	"맵고 싸하다, (대하기) 어렵다"
～圏	～けん	~권
権威	けんい	권위
健全な	けんぜんな	건전한
厳密な	げんみつな	엄밀한
向上	こうじょう	항상
心得	こころえ	"소양, 이해"
心強い	こころづよい	마음 든든하다
こじれる		"꼬이다, (병이) 악화되다"
誇張	こちょう	과장
こつ		요령
ことごとく		"모조리, 죄다"
ことによると		"어쩌면, 경우에 따라서는"
孤立	こりつ	고립
ごろごろ		데굴데굴
サイズ		사이즈
再発	さいはつ	재발
さえる		(머리가) 맑아지다
察する	さっする	"헤아리다, 살피다"
さも		"자못, 아주, 정말로"
しいて		"굳이, 억지로"
自覚	じかく	자각
しかけ		"장치, 속임수"
辞退	じたい	사퇴
シック		"멋진 모양, 세련된 모양"
しぶとい		"고집이 세다, 강인하다"
視野	しや	시야
ジャンル		장르
収容	しゅうよう	수용
主導権	しゅどうけん	주도권
処置	しょち	"처치, 조치"
進呈	しんてい	"진정, 증정, 드림"
すがすがしい		상쾌하다
すばしこい		민첩하다
スペース		공간
切実な	せつじつな	절실한
摂取	せっしゅ	섭취
せつない		"애달프다, 괴롭다"
設立	せつりつ	설립
セレモニー		"세레모니, 의식"
選考	せんこう	"선고, 전형"
備わる	そなわる	갖추어지다
そっけない		"무정하다, 냉담하다"
台無し	だいなし	엉망이 됨
打開	だかい	타개
だるい		나른하다
断言	だんげん	단언
忠告	ちゅうこく	충고
直感的に	ちょっかんてきに	직감적으로
つじつま		"사리, 이치"
貫く	つらぬく	관철하다
手遅れ	ておくれ	"때늦음, 시기를 놓침"
デザート		"디저트, 후식"
手順	てじゅん	"순서, 절차"
データ		데이터
同意	どうい	동의
同感	どうかん	동감
統合	とうごう	통합
到底	とうてい	도저히
どうにか		"그럭저럭, 겨우"
特技	とくぎ	특기
とぼける		시치미를 떼다
取り締まる	とりしまる	단속하다
取り次ぐ	とりつぐ	"전하다, (전화를) 연결하다"
何とぞ	なにとぞ	"부디, 아무쪼록"
なれなれしい		"지나치게 친한 척하다, 허물없다"
ナンセンス		넌센스
望ましい	のぞましい	바람직하다
ばかばかしい		몹시 어리석다
破棄	はき	파기
はじく		"튀기다, 튕겨 내다"
生やす	はやす	(수염 · 초목 등을) 기르다
ひいては		(더) 나아가서는
一息	ひといき	한숨 돌림
貧弱な	ひんじゃくな	빈약한
ファイト		투지
フォーム		"폼, 모양"
深まる	ふかまる	깊어지다
ふらふら		"휘청휘청, 비틀비틀"
ぶらぶら		① 대롱대롱 ② 어슬렁어슬렁 ③ 빈둥빈둥
振り出し		"출발점, 처음 상태"
付録	ふろく	부록
便宜	べんぎ	편의
返却	へんきゃく	"반납, 반환"
補充	ほじゅう	보충
募集	ぼしゅう	모집
ぼやける		흐려지다
見苦しい	みぐるしい	보기 흉하다
密接な	みっせつな	밀접한
見積もる	みつもる	"어림잡다, 견적 · 평가하다"
身なり	みなり	옷차림
身の回り	みのまわり	신변
未練	みれん	미련
明白な	めいはくな	명백한
名誉	めいよ	명예
目覚しい	めざましい	눈부시다
面倒を見る	めんどうをみる	돌봐주다
情報網	じょうほうもう	정보망
模型	もけい	모형
目下	もっか	"목하, 현재"
もてなす		"대접하다, 환대하다"
もろに		"정면으로, 직접"
野心	やしん	야심
ややこしい		"복잡하다, 까다롭다"
誘惑	ゆうわく	유혹
ゆとり		여유
抑制	よくせい	억제
よみがえる		되살아나다
リード		리드
連帯	れんたい	연대
ロマンチック		"로맨틱함, 낭만적임"
論理	ろんり	논리
割り込む	わりこむ	끼어들다
懸念	けねん	"염려, 우려"
心配する	しんぱいする	걱정하다
やつれる		"야위다, 여위다"
やせ衰える	やせおとろえる	수척해지다
奮闘する	ふんとうする	분투하다
必死に	ひっしに	필사적으로
不慮の	ふりょの	뜻밖의
思いがけない	おもいがけない	"뜻밖이다, 의외이다"
根こそぎ	ねこそぎ	"전부, 몽땅"
没頭する	ぼっとうする	몰두하다
熱中する	ねっちゅうする	열중하다
尺度	しゃくど	척도
基準	きじゅん	기준
わずらわしい		"성가신, 까다로운"
面倒な	めんどうな	귀찮은
はかどる		진척되다
しきたり		"관습, 관례"
慣習	かんしゅう	관습
触発	しゃくはつ	촉발
刺激	しげき	자극
閉口した	へいこうした	질렸다
気ままな	きままな	"제멋대로의, 자유로운"
若干	じゃっかん	약간
いくつか		약간
手分け	てわけ	분담
分担	ぶんたん	분담
調達	ちょうたつ	조달
スポット		장소
拮抗する	きっこうする	팽팽하다
差がない	さがない	차이가 없다
あどけない		천진난만한
無邪気な	むじゃきな	천진난만한
絶賛する	ぜっさんする	극찬하다
くつろいで		편안히 쉬고
うやむやに		흐지부지
出馬する	しゅつばする	출마하다
お手上げだ	おてあげだ	속수무책이다
どうしようもない		어찌할 도리가 없다
寡黙な	かもくな	과묵한
口数が少ない	くちかずがすくない	말수가 적은
紛糾する	ふんきゅうする	"시끄러워지다, 분규가 일어나다"
混乱する	こんらんする	혼란스럽다
ずれ込む	ずれこむ	"늦춰지다, 다음 기한까지 넘어가다"
ろくに		"제대로, 충분히 (부정)"
たいして		"그다지, 별로"
スケール		"스케일, 규모"
規模	きぼ	규모
エキスパート		"엑스퍼트, 전문가"
専門家	せんもんか	전문가
凝視する	ぎょうしする	응시하다
じっと見る	じっとみる	지그시 보다
かねがね		"전부터, 진작부터"
当面		당분간
ぼやく		투덜거리다
愚痴を言う	ぐちをいう	투덜거리다
コンパクトな		소형의
小型	こがた	소형
極力	きょくりょく	"극력, 힘껏, 최대한"
できるだけ		가능한 한
つぶやく		"중얼거리다, 투덜대다"
不審な	ふしんな	"수상한, 의심스러운"
ばてる		지치다
まっとうする		"완수하다, 다하다"
完了する	かんりょうする	완료하다
異例の	いれいの	이례적인
打ち込む	うちこむ	몰두하다
ルーズな		허술한
だらしない		"야무지지 못한, 허술한"
脈絡		맥락
つながり		"연계, 연관"
つぶさに		"자세히, 구체적으로"
検討	けんとう	검토
すみやかに		"빨리, 신속히"
妨害する	ぼうがいする	방해하다
エレガントな		우아한
つかの間の	つかのまの	잠깐 동안의
しくじる		"망치다, 실패하다"
失敗する	しっぱいする	실패하다
スライス		슬라이스
めいめいに		각각에게
手立て	てだて	"방법, 방도"
ありありと		뚜렷이
しぶる		주저하다
粘り強く	ねばりづよく	끈기 있게
入念に	にゅうねんに	"공들여, 꼼꼼히"
うすうす		어렴풋이
なんとなく		"왠지 모르게, 그냥"
難点	なんてん	"난점, 곤란한 점"
むっとする		"화가 치밀다, 욱하다"
照会	しょうかい	"조회, 문의"
抱負	ほうふ	포부
決意	けつい	결의
余裕	よゆう	여유
わずか		"조금, 약간"
撤回する	てっかいする	철회하다
張り合う	はりあう	경쟁하다
競い合う	きそいあう	경쟁하다
かたくなな		"완고한, 고집이 센"
端的に	たんてきに	단적으로
かろうじて		"겨우, 간신히"
何とか	なんとか	"그럭저럭, 간신히"
自尊心	じそんしん	자존심
プライド		"프라이드, 자존심"
ささいな		사소한
とまどう		"당황하다, 망설이다"
故意に	こいに	고의로
わざと		일부러
おわび		사죄
意気込み	いきごみ	"의욕, 기세, 패기"
おびえる		"무서워하다, 겁먹다"
安堵する	あんどする	안도하다
ほっとする		안심하다
仕上がる	しあがる	완성되다
完成する	かんせいする	완성되다
互角	ごかく	"호각, 막상막하"
苦情	くじょう	"불평, 불만"
助言	じょげん	조언
アドバイス		"어드바이스, 충고"
錯覚	さっかく	착각
勘違い	かんちがい	착각
殺到	さっとう	쇄도
弁解する	べんかいする	변명하다
ありふれた		"어디에나 있는, 흔해빠진"
うろたえる		당황하다
慌てる	あわてる	허둥대다
糸口	いとぐち	"실마리, 단서"
ヒント		힌트
ふいに		느닷없이
無償で		무상으로
ただで		무료로
ストレートに		"단도직입적으로, 솔직하게"
率直に	そっちょくに	솔직하게
格段に	かくだんに	현격히
いたって		"지극히, 대단히"
案の定	あんのじょう	"아니나다를까, 예측대로"
不用意な	ふよういな	조심성이 없는
不注意な	ふちゅういな	부주의한
回想	かいそう	회상
思い返す	おもいかえす	다시 생각하다
従来の	じゅうらいの	종래의
これまでの		지금까지의
抜群	ばつぐん	"발군, 뛰어남"
バックアップ		"백업, 지원"
支援	しえん	지원
仰天	ぎょうてん	"깜짝 놀람, 기겁함"
おおむね		"대체로, 대강"
雑踏	ざっとう	"혼잡, 혼잡한 곳"
人込み	ひとごみ	"붐빔, 북적임, 북적이는 곳"
メカニズム		"메커니즘, 구조"
しくみ		구조
裏づけ	うらづけ	"뒷받침, 확증"
証拠	しょうこ	증거
すべがない		방법이 없다
せかす		재촉하다
急がす	いそがす	재촉하다
さわやかな		상쾌한
簡素な	かんそな	간소한
シンプルな		단순한
ひそかに		"살짝, 몰래"
こっそり		몰래
断念	だんねん	단념
おのずと		"저절로, 자연히"
しきりに		"자주, 몇 번씩이나"
先方	せんぽう	상대편
おっくうな		"귀찮은, 번거로운"
画期的な	かっきてきな	획기적인
もくろむ		계획하다
手がかり	てがかり	단서
にわかには		당장에는
重宝する	ちょうほうする	"편리하다, 도움이 되다"
ありきたりの		"흔한, 평범한"
落胆	らくたん	낙담
がっかりする		실망하다
あっけない		"어이없다, 싱겁다"
コントラスト		대비
対比	たいひ	대비
なじむ		익숙해지다
朗報	ろうほう	"낭보, 기쁜 소식"
いやみ		"빈정거림, 비아냥"
皮肉	ひにく	"비꼼, 야유"
まばらだ		드문드문하다
どんより		우중충한 모양
やむをえず		어쩔 수 없이
しかたなく		어쩔 수 없이
収容する	しゅうようする	수용하다
目がさえる	めがさえる	"잠이 안 오다, 눈이 말똥말똥하다"
痛烈な	つうれつな	통렬한
もろくなる		"약해지다, 무너지기 쉽다"
解約	かいやく	해약하다
特産	とくさん	특산
問い詰める	といつめる	추궁하다
手厚く	てあつく	극진히
デマ		"헛소문, 유언비어"
結末	けつまつ	결말
そそる		돋우다
要請	ようせい	요청
ぎこちない		"어색하다, 딱딱하다"
断じて	だんじて	결코
出荷	しゅっか	출하
譲る	ゆずる	"넘겨주다, 양도하다"
底力	そこちから	저력
絶大な	ぜつだいな	절대적인
手痛い	ていたい	"뼈아픈, 심한"
誘致する	ゆうちする	유치하다
均等に	きんとうに	균등하게
押収する	おうしゅうする	압수하다
リタイアする		기권하다
秘める	ひめる	간직하다
絶滅する	ぜつめつする	"멸종되다, 절멸하다"
素早い	すばやい	재빠른
露骨に	ろこつに	노골적으로
交付	こうふ	교부
なつく		"따르다, 친해지다"
失脚する	しっきゃくする	실각하다
解明する	かいめいする	"풀어내다, 해명하다"
ほほえましい		흐뭇하다
目安に	めやすに	목표로
様相	ようそう	"양상, 모양, 모습"
要望	ようぼう	요망
繫盛する	はんじょうする	번창하다
くじける		좌절하다
ひたむきな		한결같은
巧みな	たくみな	정교한
配属	はいぞく	배속
乗り出す	のりだす	착수하다
面識	めんしき	"면식, 안면"
作動	さどう	작동
基調に	きちょうに	"기조로, 바탕으로"
かさばる		부피가 커지다
備え付ける	そなえつける	"설치하다, 비치하다"
交錯する	こうさくする	"이리 저리 뒤섞이다, 교착하다"
昇進	しょうしん	승진
配布	はいふ	배포
滅びる	ほろびる	"멸망하다, 쇠퇴하다"
発足する	ほっそくする	발족하다
提起	ていき	제기
重複	じゅうふく	중복
拠点	きょてん	거점
真っ先に	まっさきに	맨 먼저
緊密な	きんみつな	긴밀한
遂げる	とげる	이루다
うなだれる		"고개를 숙이다, 고개를 떨구다"
規制	きせい	규제
入手	にゅうしゅ	입수
退く	しりぞく	물러나다
閑静な	かんせいな	조용한
たやすく		쉽게
内訳	うちわけ	"내역, 명세"
食い違う	くいちがう	"어긋나다, 엇갈리다"
過密	かみつ	"빽빽함, 과밀"
人手	ひとで	일손
今更	いまさら	이제와서
くまなく		빠짐없이
辞任	じにん	사임
軌道	きどう	궤도
帯びる	おびる	"(성질, 성분, 경향을) 띠다"
思い詰める	おもいつめる	골똘히 생각하다
一律に	いちりつに	일률적으로
はがす		"떼다, 벗기다"
心構え	こころがまえ	"마음가짐, 각오"
しがみつく		매달리다
損なう	そこなう	"① 파손하다 ② (건강 · 기분) 상하게 하다, 해치다"
工面する	くめんする	변통하다
携わる	たずさわる	종사하다
裏腹に	うらはらに	"달리, 정반대로"
抱え込む	かかえこむ	① (양팔로) 껴안다 ② (많은 것을) 떠맡다
耐えがたい	たえがたい	"(괴로움, 외부의 자극을) 견디기 힘들다"
人一倍	ひといちばい	"두 배, 갑절"
復旧する	ふっきゅうする	복구되다
かばう		"감싸다, 두둔하다"
優位	ゆうい	우위
気配	けはい	"낌새, 기미"
合致する	がっちする	"일치하다, 합치하다"
加味する	かみする	"더하다, 가미하다"
口出しする	くちだしする	참견하다
拍子に	ひょうしに	"~한 순간에, ~한 찰나에"
煩雑な	はんざつな	번잡한
当てはめる	あてはめる	"꼭 들어 맞추다, 적용시키다"
免除	めんじょ	면제
ブランク		공백 기간
見込み	みこみ	"예정, 전망"
満たない	みたない	"차지 않다, 미달이다"
有数の	ゆうすうの	"유수의, 손꼽히는"
広大な	こうだいな	광대한
総じて	そうじて	"대체로, 일반적으로, 원래"
無造作に	むぞうさに	아무렇게나
連携する	れんけいする	제휴하다
不服	ふふく	"불복, 불만"
ほどける		풀어지다
目覚しい	めざましい	눈부신
見失う	みうしなう	(시야에서) 놓치다
密集	みっしゅう	밀집
ひとまず		일단
にぎわう		붐비다
満喫	まんきつ	만끽
細心	さいしん	세심
意地	いじ	고집
一括	いっかつ	"일괄, 한데 묶음"
一見	いっけん	언뜻 보기에
いやに		"이상하게, 묘하게"
(～は)おろか		"(~은) 고사하고, (~은) 물론"
仮に	かりに	"가령, 임시로"
完璧な	かんぺきな	완벽한
きざ		"불쾌함, 아니꼬움"
欠如	けつじょ	결여
高尚な	こうしょうな	고상한
しなやかな		"유연한, 탄력 있고 부드러운"
終日	しゅうじつ	종일
照合	しょうごう	대조
親善	しんぜん	친선
ショック		"쇼크, 충격"
ずらっと		"늘어선 모양, 주욱"
相応	そうおう	"상응, 어울림"
そらす		"(딴 데로) 돌리다, 빗나가게 하다"
単一	たんいつ	단일
中毒	ちゅうどく	중독
どうやら		"어쩐지, 아무래도"
とぐ		갈다
とっさに		순간적으로
突如	とつじょ	"갑자기, 별안간"
ののしる		"욕을 퍼붓다, 매도하다"
腹が立つ	はらがたつ	화가 나다
品種	ひんしゅ	품종
不順	ふじゅん	"불순, 순탄치 못함"
不満	ふまん	불만
ぺこぺこ		굽실굽실
へりくだる		겸손하다
ボイコット		"보이콧, 불매 동맹"
ぼつぼつ		"슬슬, 조금씩"
まるまる		"전부, 완전히"
よほど		"훨씬, 상당히"
両立	りょうりつ	"양립, 병행"
