挨拶	あいさつ	인사
合図	あいず	"(눈짓, 몸짓, 소리) 신호"
相次ぐ	あいつぐ	"잇따르다, 연달다"
アイデア		"아이디어, 구상"
あいにく		공교롭게도
曖昧な	あいまいな	애매한
明かり	あかり	"등불, 불빛"
明らかな	あきらかな	분명한
悪影響	あくえいきょう	악영향
悪条件	あくじょうけん	악조건
悪天候	あくてんこう	악천후
あくび		하품
憧れ	あこがれ	동경
憧れる	あこがれる	동경하다
浅い	あさい	얕다
鮮やかな	あざやかな	"선명한, 또렷한"
足元	あしもと	발밑
預ける	あずける	맡기다
与える	あたえる	주다
温かい	あたたかい	다정하다
頭に来る	あたまにくる	화가 나다
辺り	あたり	"주변, 주위"
あちこち		이곳저곳
厚かましい	あつかましい	뻔뻔하다
圧勝	あっしょう	압승
圧倒的	あっとうてき	압도적
当てる	あてる	맞추다
アピール		"어필, 호소"
危ない	あぶない	"위험하다, 위태롭다"
溢れる	あふれる	넘치다
甘い	あまい	"달다, 엄하지 않다"
甘やかす	あまやかす	응석을 받아주다
アメリカ流	アメリカりゅう	미국식
怪しい	あやしい	수상하다
誤る	あやまる	"잘못되다, 실수하다, 틀리다"
誤り	あやまり	"잘못, 실수, 틀림"
荒い	あらい	"거칠다, 거세다"
予め	あらかじめ	"사전에, 미리"
争う	あらそう	"다투다, 경쟁하다"
改めて	あらためて	"다시, 재차, 새삼스레"
あらゆる		"모든, 온갖"
あるいは		"혹은, 또는"
アルファベット順	アルファベットじゅん	알파벳순
アレンジ		"어레인지, 변형, 각색"
慌ただしい	あわただしい	"어수선하다, 바쁘다"
慌てる	あわてる	"허둥대다, 당황하다"
哀れ	あわれ	"불쌍함, 가여움"
安易な	あんいな	"손쉬운, 안이한"
案外	あんがい	"뜻밖에, 의외로, 예상 외로"
案の定	あんのうじょう	"예상대로, 아니나 다를까"
いい加減な	いいかげんな	"건성인, 무책임한"
言い難い	いいがたい	말하기 어렵다
言い訳	いいわけ	변명
委員会	いいんかい	위원회
意外な	いがいな	의외인
医学界	いがくかい	의학계
生き生き	いきいき	"생생한 모양, 활기참"
勢い	いきおい	"기세, 힘"
いきなり		갑자기
息抜き	いきぬき	"잠시 쉬다, 숨을 돌리다"
育児	いくじ	육아
勇ましい	いさましい	용감하다
維持	いじ	유지
いじめる		괴롭히다
いじる		만지다
異常な	いじょうな	이상한
異色な	いしょくな	이색적인
泉	いずみ	샘
依然として	いぜんとして	여전히
忙しい	いそがしい	바쁘다
痛い	いたい	아프다
偉大な	いだいな	위대한
抱く	いだく	(마음에) 품다
傷む	いたむ	상하다
いちいち		"일일이, 하나하나"
一応	いちおう	"일단, 우선"
著しい	いちじるしい	"현저하다, 두드러지다"
一日おきに	いちにちおきに	하루 걸러
一気に	いっきに	단숨에
～一色	～いっしょく	~ 일색
一斉に	いっせいに	"일제히, 동시에"
一層	いっそう	한 층
いったん		"일단, 우선"
一転	いってん	완전히 바뀜
いつのまにか		어느새
移転	いてん	이전
緯度	いど	위도
祈る	いのる	기도하다
違反	いはん	위반
異文化	いぶんか	이문화
今に	いまに	머지않아
意欲	いよく	의욕
依頼	いらい	의뢰
いらいら		초조해 함
医療	いりょう	의료
岩	いわ	바위
祝い	いわい	축하(선물)
祝う	いわう	축하하다
いわば		"말하자면, 예를 들면"
いわゆる		"소위, 이른바"
印刷	いんさつ	인쇄
引退	いんたい	은퇴
引用	いんよう	인용
植木	うえき	"정원수, 분재"
伺う	うかがう	"여쭙다, 뵙다"
浮く	うく	"떠오르다, 들뜨다"
受け入れる	うけいれる	받아들이다
薄い	うすい	"얇다, 연하다, 싱겁다, 적다"
薄暗い	うすぐらい	"조금 어둡다, 침침하다"
薄める	うすめる	"묽게 하다, 연하게 하다"
疑い	うたがい	의심
疑う	うたがう	의심하다
打ち明ける	うちあける	"밝히다, 털어놓다"
打ち消す	うちけす	부정하다
宇宙	うちゅう	우주
映る	うつる	비치다
うつむく		고개를 숙이다
腕	うで	"팔, 솜씨"
うとうと		꾸벅꾸벅 조는 모양
うなずく		"수긍하다, 고개를 끄덕이다"
うわさ		소문
運送	うんそう	운송
永久	えいきゅう	"영구, 영원"
営業	えいぎょう	영업
会釈	えしゃく	가벼운 인사
エネルギー		에너지
絵の具	えのぐ	그림물감
偉い	えらい	훌륭하다
得る	える	얻다
延期	えんき	"연기, 미룸"
演技	えんぎ	연기
援助	えんじょ	"원조, 도움"
エンジン		엔진
演説	えんぜつ	연설
延長	えんちょう	연장
追い越す	おいこす	추월
オイル		"오일, 기름"
応援	おうえん	응원
応援団	おうえんだん	응원단
応対	おうたい	"응대, 접다"
横断	おうだん	횡단
欧米	おうべい	구미(유럽과 미국)
覆う	おおう	"덮다, 씌우다"
大げさな	おおげさな	과장된
大幅な	おおはばな	대폭적인
お菓子	おかし	과자
お構いなく	おかまいなく	신경 쓰지 마세요
お勘定	おかんじょう	"계산, 지불"
補う	おぎなう	보충하다
～億	～おく	~억
置く	おく	"놓다, 두다"
臆病	おくびょう	"겁쟁이, 겁이 많음"
贈る	おくる	선물하다
遅れる	おくれる	"늦다, 뒤쳐지다"
怒る	おこる	화내다
幼い	おさない	"어리다, 미숙하다, 유치하다"
納める	おさめる	"넣다, 납입하다, 납부하다"
おしゃべり		"수다, 수다스러움"
お世話になる	おせわになる	신세를 지다
おそらく		"아마, 어쩌면"
お互いに	おたがいに	서로
穏やかな	おだやかな	온화한
落ち込む	おちこむ	"기가 죽다, 침울해지다"
落ち着く	おちつく	"침착하다, 차분하다"
踊り	おどり	춤
劣る	おとる	뒤떨어지다
衰える	おとろえる	"쇠약해지다, 쇠퇴하다"
驚かせる	おどろかせる	놀래키다
主	おも	주된
思いがけない	おもいがけない	"의외의, 뜻밖의"
思い切って	おもいきって	과감히
思いつく	おもいつく	생각이 떠오르다
主に	おもに	주로
親子連れ	おやこづれ	부모와 자녀 동반
お湯	おゆ	더운 물
泳ぐ	およぐ	헤엄치다
およそ		"대략, 약"
お詫び	おわび	"사죄, 사과"
温厚な	おんこうな	온후한
温泉	おんせん	온천
温暖な	おんだんな	온난한
会員制	かいいんせい	회원제
会見	かいけん	회견
外見	がいけん	"(사람) 겉모습, 외견"
介護	かいご	"간호, 간병"
開催	かいさい	개최
改札口	かいさつぐち	개찰구
解散	かいさん	해산
買い占める	かいしめる	"(상품, 주식) 매점하다"
会社員風	かいしゃいんふう	회사원 같은
解消	かいしょう	해소
改正	かいせい	개정
改善	かいぜん	개선
改造	かいぞう	개조
会談	かいだん	회담
快適な	かいてきな	쾌적한
ガイド		"안내, 가이드"
回復	かいふく	회복
解約	かいやく	"해약, 해지"
抱える	かかえる	"(문제) 안다, 떠안다, 책임지다"
輝かしい	かがやかしい	"빛나다, 눈부시다"
かかりつけ		늘 같은 의사에게 진료받는
覚悟	かくご	각오
拡充	かくじゅう	확충
隠す	かくす	"감추다, 숨기다"
拡大	かくだい	확대
拡張	かくちょう	확장
学年別	がくねんべつ	학년별
確保	かくほ	확보
下降	かこう	"하강, 추락"
囲む	かこむ	둘러싸다
かさかさ		"꺼칠꺼칠함, 버석버석함"
重ねる	かさねる	"거듭하다, 겹치다"
賢い	かしこい	"현명하다, 영리하다"
過剰な	かじょうな	과잉인
かすかな	かすかな	"희미한, 어렴풋한"
風邪気味	かぜぎみ	감기 기운
家族連れ	かぞくづれ	가족 동반
肩	かた	어깨
傾く	かたむく	"기울다, 치우치다"
固める	かためる	굳히다
偏る	かたよる	치우치다
格好	かっこう	"모양, 모습"
がっかり		"낙담, 실망"
かつて		일찍이
勝手な	かってな	"제멋대로 구는, 제멋대로인"
活発な	かっぱつな	활발한
仮定	かてい	가정
叶う	かなう	이루어지다
必ず	かならず	"반드시, 꼭"
可能性	かのうせい	가능성
かばう		"감싸다, 비호하다"
壁	かべ	벽
構わない	かまわない	상관없다
貨物	かもつ	화물
空	から	속이 빔
辛い	からい	맵다
仮採用	かりさいよう	임시 채용
カロリー		"칼로리, 열량"
革靴	かわぐつ	가죽 구두
感覚	かんかく	감각
環境	かんきょう	환경
関係	かんけい	관계
簡潔な	かんけつな	간결한
観察	かんさつ	관찰
感謝	かんしゃ	감사
頑丈な	がんじょうな	튼튼하고 옹골찬
関心	かんしん	관심
感心	かんしん	"감탄, 기특함"
乾燥	かんそう	건조
観測	かんそく	관측
缶詰	かんづめ	통조림
願望	がんぼう	"바람, 소원"
勧誘	かんゆう	권유
管理	かんり	관리
管理下	かんりか	관리하
完了	かんりょう	완료
記憶	きおく	기억
機会	きかい	기회
企画	きかく	기획
気軽に	きがるに	"선뜻, 가벼운 마음으로"
効く	きく	"약효가 듣다, 효과가 있다"
危険	きけん	위험
機嫌	きげん	"기분, 심기"
期限切れ	きげんぎれ	기한이 다 됨
危険性	きけんせい	위험성
気候	きこう	기후
岸	きし	"물가, 절벽, 벼랑"
気事	きじ	기사
技術	ぎじゅつ	기술
規制	きせい	규제
帰省	きせい	귀성
競う	きそう	"겨루다, 경쟁하다"
貴重な	きちょうな	귀중한
切っ掛け	きっかけ	"계기, 동기"
喫茶店	きっさてん	"찻집, 카페"
ぎっしり		"가득, 잔뜩, 빽빽이"
きっぱり		"딱 잘라, 단호히"
きつい		꽉 끼다
気に入る	きにいる	마음에 들다
記入	きにゅう	기입
機能	きのう	기능
寄付	きふ	기부
規模	きぼ	규모
決まる	きまる	"결정되다, 정해지다"
奇妙な	きみょうな	기묘한
疑問	ぎもん	의문
客	きゃく	손님
キャンパス		"캠퍼스, (대학) 교정"
求人	きゅうじん	구인
旧制度	きゅうせいど	구 제도
休息	きゅうそく	휴식
牛乳	ぎゅうにゅう	우유
共感	きょうかん	공감
器用な	きような	손재주가 있는
教育	きょういく	교육
教師	きょうし	교사
行事	ぎょうじ	행사
競争	きょうそう	경쟁
共通	きょうつう	공통
共同	きょうどう	공동
恐怖	きょうふ	공포
協力	きょうりょく	협력
許可	きょか	허가
漁業	ぎょぎょう	어업
極端	きょくたん	극단
巨大な	きょだいな	거대한
拒否	きょひ	거부
距離	きょり	거리
ぎりぎり		"아슬아슬함, 빠듯한"
記録	きろく	기록
議論	ぎろん	의논
～際	～ぎわ	~할 때
気をつける	きをつける	"조심하다, 주의하다"
金額	きんがく	금액
禁止	きんし	금지
区域	くいき	구역
空港	くうこう	공항
偶然	ぐうぜん	우연히
靴	くつ	"신발, 구두"
苦情	くじょう	"불평, 불만"
くたくた		녹초가 됨
くたびれる		지치다
ぐちを言う	ぐちをいう	푸념을 하다
ぐったり		"녹초가 됨, 늘어짐"
くどい		"장황하다, 지긋지긋하다"
雲	くも	구름
悔しい	くやしい	분하다
悔やむ	くやむ	"후회하다, 애석하게 여기다"
暮らす	くらす	"살다, 생활하다"
包む	くるむ	"감싸다, 둘러싸다"
くれぐれも		아무쪼록
暮れる	くれる	(날이) 저물다
苦労	くろう	고생
詳しい	くわしい	"상세하다, 자세하다"
訓練	くんれん	훈련
経営	けいえい	경영
景気	けいき	경기
契機	けいき	"계기, 동기"
掲示	けいじ	게시
形式	けいしき	형식
軽傷	けいしょう	경상
継続	けいぞく	계속
系統	けいとう	계통
芸能	げいのう	예능
警備	けいび	경비
景色	けしき	경치
下旬	げじゅん	하순
削る	けずる	"깎다, 삭감하다"
結果	けっか	결과
欠陥	けっかん	결함
結婚観	けっこんかん	결혼관
欠点	けってん	결점
結論	けつろん	결론
気配	けはい	"기색, 기미"
煙	けむり	연기
険しい	けわしい	"험악하다, 험상궂다"
原因	げんいん	원인
見解	けんかい	견해
限界	げんかい	한계
健康	けんこう	건강
検査	けんさ	검사
現実離れ	げんじつばなれ	현실과 동떨어짐
現社長	げんしゃちょう	현 사장
現象	げんしょう	현상
研修	けんしゅう	연수
厳重な	げんじゅうな	엄중한
建設	けんせつ	건설
現段階	げんだんかい	현 단계
県庁	けんちょう	현청
限定	げんてい	한정
見当	けんとう	"예측, 짐작"
濃い	こい	"짙다, 진하다"
強引な	ごういんな	"반대를 무릅쓰는, 억지부리는"
講演	こうえん	강연
硬貨	こうか	"금속화폐, 동전"
郊外	こうがい	교외
公害	こうがい	공해
講義	こうぎ	강의
貢献	こうけん	공헌
交差点	こうさてん	교차로
講師	こうし	강사
高収入	こうしゅうにゅう	고수입
高水準	こうすいじゅん	높은 수준
高性能	こうせいのう	고성능
高層	こうそう	고층
構造	こうぞう	구조
交代	こうたい	교대
好調	こうちょう	"호조, 순조, 좋은 상태임"
行動	こうどう	행동
合同	ごうどう	합동
鉱物	こうぶつ	광물
声	こえ	(목)소리
越える	こえる	"넘다, 초월하다"
ご遠慮なく	ごえんりょなく	사양 않고
氷	こおり	얼음
凍る	こおる	얼다
小柄な	こがらな	몸집이 작은
故郷	こきょう	고향
国際	こくさい	국제
国際色	こくさいしょく	국제색
克服	こくふく	극복
ご苦労様	ごくろうさま	수고하셨습니다
焦げる	こげる	"타다, 눋다"
心強い	こころづよい	마음 든든하다
快い	こころよい	"상쾌하다, 유쾌하다, 즐겁다"
腰	こし	허리
個人的な	こじんてきな	개인적인
ごちゃごちゃ		"어지러이 뒤섞임, 너저분한 모양"
こつこつ		꾸준히 노력하는 모양
骨折	こっせつ	골절
小包	こづつみ	소포
異なる	ことなる	다르다
子供連れ	こどもづれ	아이 동반
断る	ことわる	거절하다
困る	こまる	"곤란하다, 어려움을 겪다"
コミュニケーション		"커뮤니케이션, 의사 전달"
娯楽	ごらく	오락
ごろごろ		"뒹굴뒹굴, 데굴데굴"
怖い	こわい	무섭다
コンクール		"콩쿠르, 경연 대회"
混乱	こんらん	혼란
～際	～さい	~때
最高	さいこう	최고
再開発	さいかいはつ	재개발
再三	さいさん	"재삼, 여러 번"
催促	さいそく	재촉
再提出	さいていしゅつ	재제출
在籍	ざいせき	재적
再度	さいど	"재차, 다시"
才能	さいのう	재능
栽培	さいばい	재배
裁判	さいばん	재판
財布	さいふ	지갑
再放送	さいほうそう	재방송
最有力	さいゆうりょく	가장 유력함
再利用	さいりよう	재사용
幸いな	さいわいな	다행스러운
サイン		"사인, 서명"
坂	さか	언덕
探す	さがす	찾다
逆らう	さからう	"거스르다, 거역하다"
作業	さぎょう	작업
咲く	さく	(꽃이) 피다
削除	さくじょ	삭제
作成	さくせい	작성
作品集	さくひんしゅう	작품집
酒	さけ	술
叫ぶ	さけぶ	"외치다, 부르짖다"
ささやく	ささやく	속삭이다
差し支え	さしつかえ	"지장, 장애"
差し支える	さしつかえる	지장이 있다
誘う	さそう	(같이 하길) 권하다
定める	さだめる	"정하다, 결정하다"
撮影	さつえい	촬영
さっさと		빨리빨리
雑誌	ざっし	잡지
雑談	ざつだん	잡담
さっぱり		상쾌함
さて		그건 그렇고
寒い	さむい	춥다
覚める	さめる	"잠이 깨다, 눈이 뜨이다"
参加	さんか	참가
参照	さんしょう	참조
残念な	ざんねんな	유감인
さびる		녹슬다
差別	さべつ	차별
作法	さほう	예의 범절
サンプル		"샘플, 견본"
散歩	さんぽ	산책
参考	さんこう	참고
仕上げる	しあげる	일을 끝내다
寺院	じいん	사원
司会	しかい	"(행사, 결혼식 등의) 사회"
直に	じかに	직접
時間をつぶす	じかんをつぶす	시간을 때우다
じきに		"바로, 곧"
至急	しきゅう	"시급, 급히"
敷く	しく	깔다
刺激	しげき	자극
事件	じけん	사건
取り掛かる	とりかかる	"착수하다, 시작하다"
支持	しじ	지지
指示	しじ	지시
四捨五入	ししゃごにゅう	"반올림, 사사오입"
自身	じしん	자신
地震	じしん	지진
沈む	しずむ	"가라앉다, 지다"
シーズン		"시즌, 시기, 철"
姿勢	しせい	자세
辞退	じたい	사퇴
次第に	しだいに	점차
従う	したがう	따르다
じたばた		"바둥바둥, 발버둥"
しつこい		"집요하다, 끈질기다"
実施	じっし	실시
実践	じっせん	실천
質素な	しっそな	검소한
湿度	しつど	습도
じっと		"꼼짝 않음, 가만히 있음"
実に	じつに	실로
失敗	しっぱい	"실패, 실수"
失望	しつぼう	실망
指導	しどう	지도
児童	じどう	아동
支配	しはい	지배
しびれる		"마비되다, 저리다"
自分勝手な	じぶんかってな	제멋대로인
絞る	しぼる	"조이다, (쥐어)짜다"
島	しま	섬
仕舞う	しまう	"정리하다, 치우다"
地味な	じみな	"수수한, 검소한"
染みる	しみる	"배다, 스며들다"
事務所	じむしょ	사무소
締め切り	しめきり	마감(일)
占める	しめる	"(비율, 자리 등을) 차지하다"
湿る	しめる	"축축해지다, 습기 차다"
地元	じもと	"그 지역, 그 고장, 연고지"
視野	しや	시야
弱点	じゃくてん	약점
しゃべる		"이야기하다, 수다를 떨다"
邪魔	じゃま	"방해, 거추장스러움"
周囲	しゅうい	주위
収穫	しゅうかく	수확
終日	しゅうじつ	종일
就職	しゅうしょく	취직
就職率	しゅうしょくりつ	취직률
住宅街	じゅうたくがい	주택가
集中力	しゅうちゅうりょく	집중력
柔軟な	じゅうなんな	유연한
柔軟に	じゅうなんに	유연하게
収納	しゅうのう	수납
充満	じゅうまん	"충만, 가득함"
宿泊	しゅくはく	숙박
取材	しゅざい	취재
首相	しゅしょう	수상
手術	しゅじゅつ	수술
主成分	しゅせいぶん	주성분
出世	しゅっせ	출세
出版	しゅっぱん	출판
出版社	しゅっぱんしゃ	출판사
首脳	しゅのう	"수뇌, 정상"
趣味	しゅみ	취미
寿命	じゅみょう	수영
主要	しゅよう	주요
準決勝	じゅんけっしょう	준결승
順調な	じゅんちょうな	순조로운
準備	じゅんび	준비
準優勝	じゅんゆうしょう	준우승
～賞	～しょう	~상
～状	～じょう	~상태
紹介	しょうかい	소개
蒸気	じょうき	증기
状況	じょうきょう	상황
条件	じょうけん	조건
正直な	しょうじきな	"정직한, 솔직한"
症状	しょうじょう	증상
上昇	じょうしょう	상승
生じる	しょうじる	"발생하다, 생기다"
招待	しょうたい	초대
招待状	しょうたいじょう	초대장
象徴	しょうちょう	상징
焦点	しょうてん	초점
商店街	しょうてんがい	상점가
衝突	しょうとつ	충돌
承認	しょうにん	승인
消費	しょうひ	소비
商品	しょうひん	상품
情報	じょうほう	정보
消防署	しょうぼうしょ	소방서
将来	しょうらい	장래
省略	しょうりゃく	생략
諸外国	しょがいこく	여러 외국
初期	しょき	초기
食欲	しょくよく	식욕
職場	しょくば	직장
諸国	しょこく	여러 나라
徐々に	じょじょに	서서히
食器類	しょっきるい	식기류
ショック		"쇼크, 충격"
初年度	しょねんど	"초년, 첫 년도"
初歩	しょほ	초보
署名	しょめい	서명
諸問題	しょもんだい	여러 문제
女優	じょゆう	여배우
所有	しょゆう	소유
処理	しょり	처리
資料	しりょう	자료
じろじろ		"빤히, 유심히"
進学率	しんがくりつ	진학률
真剣な	しんけんな	진지한
深刻な	しんこくな	심각한
心臓	しんぞう	심장
慎重な	しんちょうな	신중한
しばしば		"자주, 종종"
しばらく		잠시
深夜	しんや	심야
信用	しんよう	신용
信頼	しんらい	신뢰
人類	じんるい	인류
垂直	すいちょく	수직
水滴	すいてき	물방울
数年	すうねん	"여러 해, 수년"
隙	すき	"틈, 방심"
スキー場	スキーじょう	스키장
救う	すくう	"구하다, 구제하다"
優れる	すぐれる	"뛰어나다, 우수하다"
スケジュール		스케줄
涼しい	すずしい	시원하다
スタート		스타트
すっきり		"말쑥함, 상쾌함"
すなわち		즉
スピード		속도
スペース		공간
済ます	すます	"끝내다, 마치다"
すまない		미안하다
隅	すみ	"구석, 모퉁이"
スムーズ		"순조로움, 원활함"
スムーズに		순조롭게
ずるい		"치사하다, 교활하다"
鋭い	するどい	"날카롭다, 예리하다"
座る	すわる	앉다
精一杯	せいいっぱい	"힘껏, 있는 힘을 다해"
声援	せいえん	성원
性格	せいかく	성격
生活	せいかつ	생활
清潔な	せいけつな	청결한
成功	せいこう	성공
成功率	せいこうりつ	성공률
精算	せいさん	정산
政治	せいじ	정치
政治色	せいじしょく	정치색
せいぜい		기껏해야
成績	せいせき	성적
製造	せいぞう	제조
贅沢な	ぜいたくな	사치스러운
成長	せいちょう	성장
生徒	せいと	"학생 (초, 중, 고)"
政党	せいとう	정당
製品	せいひん	제품
成分	せいぶん	성분
責任	せきにん	책임
世間	せけん	"세간, 세상"
せっかく		모처럼
積極的な	せっきょくてきな	적극적인
接する	せっする	접하다
設備	せつび	설비
節約	せつやく	절약
背中	せなか	등
狭い	せまい	좁다
迫る	せまる	다가오다
せめて		적어도
責める	せめる	"탓하다, 책망하다"
前社長	ぜんしゃちょう	전 사장
戦争	せんそう	전쟁
選択	せんたく	선택
前町長	ぜんちょうちょう	전 마을 대표
専念	せんねん	전념
全般	ぜんぱん	"전반, 전체"
線路沿い	せんろぞい	기찻길 옆
相違	そうい	"상이함, 다름"
そういえば		그러고 보니
総売上	そううりあげ	"매상 총액, 판매액"
総額	そうがく	총액
相互	そうご	"상호, 서로"
操作	そうさ	조작
送信元	そうしんもと	"송신원, 발신지"
総人口	そうじんこう	총인구
想像	そうぞう	상상
騒々しい	そうぞうしい	"시끄럽다, 떠들썩하다"
装置	そうち	장치
相当	そうとう	상당히
即座に	そくざに	"즉각, 당장"
続出	ぞくしゅつ	속출
属する	ぞくする	"(단체) 속하다, 소속하다"
続々(と)	ぞくぞく(と)	"잇달아, 끊임없이"
底	そこ	"바닥, 밑"
素材	そざい	소재
組織	そしき	조직
そそっかしい		"덜렁대다, 경솔하다"
卒業	そつぎょう	졸업
そっくり		꼭 닮음
率直な	そっちょくな	솔직한
備える	そなえる	"갖추다, 대비하다"
それとも		그렇지 않으면
揃う	そろう	"갖추어지다, 모이다"
揃える	そろえる	(사이즈를) 맞추다
損	そん	손해
損害	そんがい	손해
尊敬	そんけい	존경
存在	そんざい	존재
尊重	そんちょう	존중
損得	そんとく	"손익, 손해와 이득"
退院	たいいん	퇴원
体格	たいかく	체격
退屈な	たいくつな	지루한
大した	たいした	"대단한, 특별한"
大臣	だいじん	"대신, 장관"
代表	だいひょう	대표
タイミング		타이밍
対立	たいりつ	대립
倒す	たおす	"쓰러뜨리다, 무너뜨리다"
互い	たがい	"서로, 상호"
炊く	たく	(밥을) 짓다
たくましい		늠름하다
蓄える	たくわえる	"저장하다, 비축하다"
多彩な	たさいな	다채로운
確か	たしか	아마
ただし		다만
直ちに	ただちに	"곧장, 즉시"
ただの		"단순한, 그저"
畳	たたみ	다다미
畳む	たたむ	"(이불, 옷 등을) 개다"
達する	たっする	"이르다, 도달하다"
たっぷり		"듬뿍, 많이"
たちまち		금세
妥当な	だとうな	타당
谷	たに	계곡
他人	たにん	타인
頼みづらい	たのみづらい	부탁하기 곤란하다
頼もしい	たのもしい	믿음직스럽다
束ねる	たばねる	"묶다, 통솔하다"
たびたび		"여러 번, 자주"
卵	たまご	"알, 달걀"
たまたま		"때마침, 우연히"
保つ	たもつ	(상태를) 유지하다
頼る	たよる	의지하다
～だらけ		~투성이
だらしない		"단정하지 않다, 칠칠치 못하다"
単純な	たんじゅんな	단순한
団体	だんたい	단체
担当者	たんとうしゃ	담당자
単なる	たんなる	단순한
チーム		팀
知恵	ちえ	지혜
地球	ちきゅう	지구
遅刻	ちこく	지각
知識	ちしき	지식
縮む	ちぢむ	줄어들다
縮める	ちぢめる	"줄이다, 움츠리다"
着々と	ちゃくちゃくと	"척척, 착착"
チャンス		"찬스, 기회"
ちゃんと		"제대로, 정확하게"
中継	ちゅうけい	중계
駐車	ちゅうしゃ	주차
駐車場	ちゅうしゃじょう	주차장
抽象的な	ちゅうしょうてきな	추상적인
抽選	ちゅうせん	추첨
中断	ちゅうだん	중단
注目	ちゅうもく	주목
～兆	～ちょう	~조
超過	ちょうか	초과
調査	ちょうさ	조사
頂上	ちょうじょう	정상
調節	ちょうせつ	조절
頂点	ちょうてん	"꼭대기, 정상"
直接	ちょくせつ	직접
直前	ちょくぜん	직전
著者	ちょしゃ	저자
貯蔵	ちょぞう	저장
散らかす	ちらかす	어지르다
散らかる	ちらかる	"흩어지다, 널브러지다"
治療	ちりょう	치료
追加	ついか	추가
ついている		행운이 따르다
通行	つうこう	동행
通じない	つうじない	통하지 않다
使い道	つかいみち	"용도, 쓸모"
疲れ	つかれ	피로
疲れる	つかれる	피곤하다
次々と	つぎつぎと	"잇달아, 차차"
尽きる	つきる	"다하다, 떨어지다, 끝나다"
机	つくえ	책상
伝える	つたえる	전하다
続く	つづく	"계속되다, 이어지다"
包む	つつむ	"싸다, 포장하다"
努める	つとめる	"노력하다, 힘쓰다"
務める	つとめる	"임무를 맡다, 역할을 다하다"
常に	つねに	"항상, 늘"
つまずく		"발에 걸려 넘어지다, 실패하다"
詰まる	つまる	막히다
積む	つむ	"(짐, 경력 등을) 쌓다, 싣다"
強火	つよび	센 불
強み	つよみ	"강점, 유리한 점"
辛い	つらい	괴롭다
抵抗	ていこう	저항
低価格	ていかかく	낮은 가격
低カロリー	ていカロリー	저칼로리
提供	ていきょう	제공
訂正	ていせい	정점
手軽な	てがるな	"손쉬운, 간단한"
適切な	てきせつな	적절한
適度な	てきどな	"적당한, 적절한"
テクニック		"테크닉, 기술"
手頃な	てごろな	적당한
デザイン		디자인
でたらめに		"엉터리로, 아무렇게나"
鉄橋	てっきょう	절교
徹夜	てつや	"철야, 밤샘"
手間	てま	"수고, 품"
展開	てんかい	전개
転勤	てんきん	전근
点検	てんけん	점검
電車賃	でんしゃちん	전철 요금
伝統	でんとう	전통
添付	てんぷ	첨부
テンポ		"템포, 빠르기, 박자"
問い合わせる	といあわせる	문의하다
どうしても		"기어코, 꼭"
同情	どうじょう	동정
どうせ		어차피
到着	とうちゃく	도착
導入	どうにゅう	도입
投票率	とうひょうりつ	투표율
当分	とうぶん	당분간
逃亡	とうぼう	도망
動揺する	どうようする	동요하다
道路	どうろ	도로
登録	とうろく	등록
討論	とうろん	토론
都会育ち	とかいそだち	도시에서 자람
特殊	とくしゅ	특수
特色	とくしょく	특색
独特	どくとく	독특
登山	とざん	등산
途中	とちゅう	도중
とっくに		"훨씬 전에, 벌써"
突然	とつぜん	"돌연, 갑자기"
どっと		"왈칵, 왁자글"
届く	とどく	"도착하다, 이르다"
整う	ととのう	"갖추어지다, 정돈되다"
隣	となり	옆
飛び散る	とびちる	흩날리다
飛ぶ	とぶ	날다
乏しい	とぼしい	"(경험, 물자 등이) 부족하다"
伴う	ともなう	"동반하다, 따르다"
ドライブ		드라이브
とりあえず		"일단, 우선"
努力	どりょく	"노력하다, 힘쓰다"
トレーニング		"트레이닝, 훈련, 단련"
泥	どろ	진흙
とんでもない	とんでもない	당치 않다
内容	ないよう	내용
なお		"여전히, 더욱"
仲良く	なかよく	사이좋게
流れる	ながれる	흐르다
和やかな	なごやかな	온화한
なだらかな		완만한
懐かしい	なつかしい	그립다
納得	なっとく	납득
夏休み明け	なつやすみあけ	여름방학이 끝난 직후
波	なみ	파도
涙	なみだ	눈물
悩む	なやむ	고민하다
倣う	ならう	"따르다, 모방하다"
慣れる	なれる	"익숙해지다, 습관이 되다"
何度も	なんども	"몇 번이나, 자주, 종종"
苦手な	にがてな	"서투름, 잘 못함, 어색함"
握る	にぎる	"쥐다, 잡다"
憎い	にくい	밉다
憎む	にくむ	"미워하다, 증오하다"
逃げる	にげる	도망치다
濁る	にごる	"흐려지다, 탁해지다"
日課	にっか	일과
にっこり		빙긋이
日中	にっちゅう	"주간, 낮"
鈍い	にぶい	"둔하다, 굼뜨다"
日本式	にほんしき	일본식
日本流	にほんりゅう	일본류
盗む	ぬすむ	훔치다
塗る	ぬる	"바르다, 칠하다"
願う	ねがう	바라다
熱演	ねつえん	열연
年中	ねんじゅう	"연중, 항상"
年代順	でんだいじゅん	연대순
年齢	ねんれい	"나이, 연령"
残る	のこる	남다
除く	のぞく	"제거하다, 제외하다"
ノック		노크
述べる	のべる	"서술하다, 말하다"
乗り越す	のりこす	(내릴 곳을) 지나치다
乗り継ぐ	のりつぐ	갈아타다
のんびり		"느긋함, 태평함"
歯	は	"이, 치아"
ハード		힘듦
～杯	～はい	~잔
～倍	～ばい	~배
灰色	はいいろ	"잿빛, 회색, 침울함"
廃止	はいし	폐지
配達	はいたつ	배달
配布	はいふ	배포
拍手	はくしゅ	박수
爆発	ばくはつ	폭발
激しい	はげしい	"격하다, 심하다"
恥	はじ	"부끄러움, 수치"
外す	はずす	"풀다, 벗다"
果たす	はたす	"(역할, 임무 등을) 완수하다"
働き手	はたらきて	"일꾼, 일손"
～発	～はつ	"~발, ~출발"
発揮	はっき	발휘
発射	はっしゃ	발사
発達	はったつ	발달
派手な	はでな	화려한
話しかける	はなしかける	말을 걸다
離れる	はなれる	"멀어지다, 떨어지다"
省く	はぶく	"줄이다, 생략하다"
破片	はへん	파편
場面	ばめん	장면
速さ	はやさ	빠르기
腹を立てる	はらおたてる	화를 내다
バランス		"밸런스, 균현"
針	はり	바늘
張り切る	はりきる	기운이 넘치다
範囲	はんい	범위
反映	はんえい	반영
パンク		"펑크, 터짐"
犯罪	はんざい	범죄
反省	はんせい	반성
反対	はんたい	반대
判断	はんだん	판단
半透明	はんとうめい	반투명
販売	はんばい	판매
被害	ひがい	피해
比較	ひかく	비교 
比較的な	ひかくてきな	비교적
～匹	～ひき	~마리
引き返す	ひきかえす	되돌아가다
引き止める	ひきとめる	"말리다, 붙잡다"
卑怯な	ひきょうな	비겁한
悲劇	ひげき	비극
非公式	ひこうしき	비공식
ビズネスマン風	ビズネスマンふう	비즈니스맨 풍
ひそひそ		소곤소곤
必死な	ひっしな	필사적인
びっしょり		흠뻑 젖음
必要な	ひつような	필요한
人柄	ひとがら	"인품, 성품"
等しい	ひとしい	동등하다
一仕事	ひとしごと	조금 일을 함
批判	ひはん	비판
批評	ひひょう	비평
皮膚	ひふ	피부
微妙な	びみょうな	미묘한
ひも		끈
費用	ひよう	비용
～秒	～びょう	~초
評価	ひょうか	평가
表現	ひょうげん	표현
標識	ひょうしき	"표지, 표식"
評判	ひょうばん	"평판, 유명함"
昼間	ひるま	"낮, 주간"
比例	ひれい	비례
拾う	ひろう	줍다
広がる	ひろがる	넓어지다
敏感な	びんかんな	민감한
不安	ふあん	불안
不安定	ふあんてい	불안적
ブーム		유행
ぶかぶか		헐렁헐렁
普及	ふきゅう	보급
副社長	ふくしゃちょう	부사장
副大臣	ふくだいじん	"부대신, 차관"
含む	ふくむ	포함하다
含める	ふくめる	"포함시키다, 내포하다"
塞ぐ	ふさぐ	"틀어막다, 가리다"
相応しい	ふさわしい	"적합하다, 어울리다"
不正確な	ふせいかくな	부정확한
夫婦	ふうふ	부부
複雑な	ふくざつな	복잡한
副社	ふくし	복지
舞台	ぶたい	무대
負担	ふたん	부담
物価	ぶっか	물가
物騒な	ぶっそうな	"뒤숭숭한, 위험한"
部分的な	ぶぶんてきな	부분적인
不平	ふへい	불평
ふもと		산기슭
ぶらぶら		"어슬렁어슬렁, 빈둥빈둥"
プラン		"플랜, 계획"
振り向く	ふりむく	(뒤)돌아보다
降る	ふる	"(눈, 비 등이) 내리다"
プレッシャー		압력
触れる	ふれる	"(문화, 주제 등을) 접하다, 접촉하다"
分解	ぶんかい	분해
文学賞	ぶんがくしょう	문학상
分析	ぶんせき	분석
分担	ぶんたん	분담
分野	ぶんや	"분야, 활동 범위"
平均	へいきん	평균
平和	へいわ	평화
隔てる	へだてる	"시야를 떼다, 멀리하다"
別会場	べつかいじょう	"다른 회장, 다른 장소"
減る	へる	줄다
返却	へんきゃく	"(책 등을) 반환, 반납"
勉強漬け	べんきょうづけ	공부에 열중임
変更	へんこう	변경
編集	へんしゅう	편집
返品	へんぴん	반품
貿易	ぼうえき	무역
報告書	ほうこくしょ	보고서
防災	ぼうさい	방재
帽子	ぼうし	모자
方針	ほうしん	방침
宝石	ほうせき	보석
豊富な	ほうふな	풍부한
方法	ほうほう	방법
方々	ほうぼう	여기저기
ほぼ		"거의, 대체로"
訪問	ほうもん	방문
法律	ほうりつ	법률
ボール状	ボールじょう	"둥근 형태, 둥근 모양"
朗らかな	ほがらかな	명랑한
星	ほし	별
募集	ぼしゅう	모집
保証	ほしょう	보증
補足	ほそく	보충
保存	ほぞん	보존
ほっと		안심하는 모양
骨	ほね	"뼈, 가시"
掘る	ほる	"파다, 캐다"
ほんの		"그저, 단지"
本物	ほんもの	"진짜, 실물"
ぼんやり		"멍하니, 흐릿하게"
真新しい	まあたらしい	아주 새롭다
まあまあ		그런대로
マイペース		"자기 나름의 방식, 마이페이스"
真後ろ	まうしろ	바로 뒤
間際	まぎわ	"직전, 바로 곁"
混じる	まじる	섞이다
増す	ます	"늘다, 증가하다"
貧しい	まずしい	"가난하다, 변변찮다"
乾く	かわく	"마르다, 건조되다"
祭り	まつり	축제
窓	まど	창문
招く	まねく	"초대하다, 부르다, 초래하다"
守る	まもる	지키다
迷う	まよう	"헤매다, 망설이다"
真夜中	まよなか	한밤중
稀な	まれな	"희귀한, 드문"
万年筆	まんねんひつ	만년필
磨く	みがく	닦다
未経験	みけいけん	미경험
見事な	みごとな	훌륭한
未使用	みしよう	미사용
湖	みずうみ	호수
自ら	みずから	스스로
見出し	みだし	"표제어, 헤드라인"
乱れる	みだれる	"흐트러지다, 흐려지다"
導く	みちびく	인도하다
密接な	みっせつな	밀접한
みっともない		보기 흉하다
密閉	みっぺい	밀폐
認める	みとめる	인정하다
皆	みな	모두
見逃す	みのがす	"못 보다, 놓치다"
見本	みほん	견본
耳にする	みみにする	듣다
妙な	みょうな	묘한
未来	みらい	미래
向かい	むかい	"맞은편, 건너편, 정면"
迎え	むかえ	"맞이, 마중"
迎える	むかえる	"마중하다, 맞이하다"
昔	むかし	옛날
むかつく		"화가 치밀다, 울컥하다"
無口な	むくちな	과묵한
無計画	むけいかく	무계획
矛盾	むじゅん	모순
娘	むすめ	딸
無責任な	むせきにんな	무책임한
夢中な	むちゅうな	"열중한, 몰두한"
村	むら	마을
群れ	むれ	"때, 무리"
明確な	めりかくな	명확한
名所	めいしょ	명소
目上	めうえ	"윗사람, 연장자"
恵まれる	めぐまれる	"(좋은 환경) 혜택을 받다, 풍족함을 누리다"
めくる		(책장) 넘기다
目指す	めざす	목표로 하다
珍しい	めずらしい	"진귀하다, 드물다"
面する	めんする	"면하다, 마주보다"
面接	めんせつ	면접
面倒な	めんどうな	"귀찮은, 번거로운"
申し込み	もうしこみ	신청
申し訳ない	もうしわけない	죄송하다
目的	もくてき	목적
持つ	もつ	가지다
最も	もっとも	"가장, 무엇보다도"
戻す	もどす	"(원래 자리, 상태로) 되돌리다"
求める	もとめる	"구하다, 청하다"
物語	ものがたり	이야기
物足りない	ものたりない	어딘가 부족하다
模範	もはん	모범
催し	もよおし	"모임, 행사"
最寄	もより	"가장 가까움, 근처"
文句	もんく	"불평, 불만"
やかましい		"시끄럽다, 떠들썩하다"
約	やく	"약, 대략"
役に立つ	やくにたつ	도움이 되다
役目	やくめ	"임무, 역할"
焼ける	やける	"(불)타다, 구워지다"
養う	やしなう	기르다
家賃	やちん	집세
雇う	やとう	고용하다
敗れる	やぶれる	"지다, 패배하다"
破れる	やぶれる	찢어지다
山のふもと	やまのふもと	산기슭
やむを得ない	やむをえない	"어쩔 수 없다, 부득이하다"
辞める	やめる	"사임하다, 그만두다"
やや		"약간, 다소"
柔らかい	やわらかい	"부드러운, 유연한"
有効な	ゆうこうな	유효한
優秀な	ゆうしゅうな	우수한
優勝	ゆうしょう	우승
ユーモア		유머
有利な	ゆうりな	유리한
愉快な	ゆかいな	유쾌한
行方	ゆくえ	행방
豊かな	ゆたかな	"풍요로운, 풍부한"
譲る	ゆずる	"양도하다, 양보하다, 넘기다"
油断	ゆだん	"방심, 부주의"
溶岩	ようがん	용암
陽気な	ようきな	명랑한
要求	ようきゅう	요구
容姿	ようし	용모
用心	ようじん	"조심, 주의"
容積	ようせき	"용적, 용량"
幼稚な	ようちな	유치한
用途	ようと	용도
予測	よそく	예측
世の中	よのなか	세상
呼び止める	よびとめる	불러 세우다
予約制	よやくせい	예약제
喜ぶ	よろこぶ	"기뻐하다, 좋아하다"
ヨーロッパ風	ヨーロッパふう	"유럽풍, 유럽식"
来学期	らいがっき	다음 학기
来シーズン	らいシーズン	다음 시즌
楽な	らくな	"편안한, 쉬운"
乱暴な	らんぼうな	난폭한
レーダー		"리더, 지도자"
利益	りえき	이익
理解	りかい	이해
利口な	りこうな	영리한
略する	りゃくする	"줄이다, 생략하다"
流行	りゅうこう	유행
両替	りょうがえ	환전
両国	りょうこく	양국
領収書	りょうしゅうしょ	영수증
リラックス		"릴랙스, 편안함"
例外	れいがい	예외
礼儀	れいぎ	예의
冷静な	れいせいな	냉정함
冷蔵庫	れいぞうこ	냉장고
冷凍	れいとう	냉동
歴史	れきし	역사
レジャー		"레저, 여가"
レベル		"레벨, 수준"
連続	れんぞく	연속
レンタル		"렌트, 대여"
連絡	れんらく	연락
論争	ろんそう	논쟁
輪	わ	"원형, 고리"
我がままな	わがままな	"제멋대로 구는, 제멋대로인"
沸く	わく	"끓다, 뜨거워지다"
わずか		"약간, 불과"
笑う	わらう	웃다
割合	わりあい	비율
割合に	わりあいに	비교적
割り込む	わりこむ	"끼어들다, 새치기하다"
わりと		비교적
割引	わりびき	할인
途端に	とたんに	바로 그 순간
外れる	はずれる	"제외되다, 벗어나다"
診断	しんだん	진단
住居	じゅうきょ	주거
典型的な	てんけいてきな	전형적인
昇る	のぼる	떠오르다
俳優	はいゆう	배우
欲	よく	욕심
貴団体	きだんたい	귀 단체
クリア		"통과, 클리어"
劇的に	げきてきに	극적으로
締め切る	しめきる	마감하다
交渉	こうしょう	교섭
進出	しんしゅつ	진출
接続	せつぞく	접속
ぞろぞろ		"졸졸, 줄줄"
書籍	しょせき	서적
とがっている		"뾰족하다, 예민하다"
荒れる	あれる	"거칠어지다, 날뛰다"
打ち合わせ	うちあわせ	"협의, 미리 상의함"
ベテラン		베테랑
頑固な	がんこな	완고한
運賃	うんちん	운임
平等	びょうどう	평등
善良な	ぜんりょうな	"선량한, 어진"
損失	そんしつ	손실
布	ぬの	천
絶えず	たえず	"늘, 끊임없이"
特定	とくてい	특정
盛り上がる	もりあがる	고조되다
飛びつく	とびつく	달려들다
話題	わだい	화제
リハーサル		리허설
真似る	まねる	흉내내다
概要	がいよう	개요
各自	かくじ	각자
暮れ	くれ	"저녁때, 한 해의 마지막"
印	しるし	"표, 표시"
妨げる	さまたげる	"방해하다, 지장을 주다"
残高	ざんだか	잔고
早期	そうき	조기
腫れる	はれる	붓다
上達	じょうたつ	숙달
