愛飲	あいいん	"애음, 즐겨 마심"	
愛情	あいじょう	애정	
愛人	あいじん	"애인, 정부, 불륜 상대"	
愛着	あいちゃく	애착	
赤字	あかじ	적자	
悪意	あくい	악의	
握手	あくしゅ	악수	
悪魔	あくま	악마	
明け方	あけがた	"새벽녘, 동틀녘"	
足跡	あしあと	"발자취, 발자국"	
汗	あせ	땀	
愛	あい	사랑	
あだ		"적, 원수, 원한"	
圧縮	あっしゅく	압축	
集まり	あつまり	"모임, 회합"	
圧力	あつりょく	압력	
宛名	あてな	"받는 사람, 수신인"	
跡	あと	"자국, 흔적, 유적"	
後先	あとさき	"앞뒤, 전후"	
後始末	あとしまつ	"뒤치다꺼리, 뒤처리"	
雨戸	あまど	덧문	
余り	あまり	"나머지, 여분"	
編み物	あみもの	"편물, 뜨개질"	
あらすじ		"대충의 줄거리, 개요"	
現れ	あらわれ	"현상, 발로"	
あり		개미	
在り方	ありかた	"현실, 본연의 자세"	
安定	あんてい	안정	
あんばい		"간, 맛, 상태"	
安否	あんぴ	"안부, 안위"	
胃	い	위	
委員	いいん	위원	
医院	いいん	의원	
意義	いぎ	의의	
生き物	いきもの	생물	
幾分	いくぶん	"일부분, 조금, 약간"	
生け花	いけばな	꽃꽂이	
以後	いご	이후	
移行	いこう	이행	
遺産	いさん	유산	
意思	いし	"의사, 의향"	
意志	いし	"의지, 의욕"	
維持	いじ	유지	
移住	いじゅう	이주	
衣食住	いしょくじゅう	의식주	
板	いた	"판자, 널빤지"	
いたずら		못된 장난	
位置	いち	위치	
一助	いちじょ	"일조, 약간의 도움"	
一度	いちど	한 번	
市場	いちば	"시장, 장"	
一面	いちめん	일면	
一覧	いちらん	일람	
一家	いっか	일가	
一括	いっかつ	일괄	
一昨日	いっさくじつ	그저께	
一昨年	いっさくねん	재작년	
一瞬	いっしゅん	"일순, 일순간"	
一致	いっち	일치	
一定	いってい	일정	
一般	いっぱん	일반	
遺伝	いでん	유전	
意図	いと	의도	
井戸	いど	우물	
移動	いどう	이동	
異動	いどう	"이동, 인사이동"	
いとこ		사촌	
いとま		"틈, 겨를, 휴식"	
以内	いない	이내	
稲	いね	벼	
居眠り	いねむり	"말뚝잠, 앉아서 졺"	
衣服	いふく	"의복, 옷"	
意訳	いやく	의역	
入り口	いりぐち	입구	
入れ替え	いれかえ	"갈아 넣음, 교체"	
入れ物	いれもの	"용기, 그릇"	
印刷	いんさつ	인쇄	
飲酒	いんしゅ	음주	
飲料水	いんりょうすい	"음용수, 마실 물"	
引力	いんりょく	인력	
魚	うお	물고기	
うがい		양치질	
受け入れ	うけいれ	"받아들임, 승낙"	
受付	うけつけ	접수	
うさぎ		토끼	
内	うち	"안(쪽), 내부, 속"	
宇宙	うちゅう	우주	
写し	うつし	"(사진을) 찍음, 베낌"	
訴え	うったえ	"호소, 소송"	
打って付け	うってつけ	"알맞음, 안성맞춤"	
器	うつわ	"그릇, 용기"	
雨天	うてん	"우천, 비오는 날"	
うのみ		"통째로 삼킴, 그대로 받아들임"	
生まれ	うまれ	"탄생, 출생"	
有無	うむ	유무	
梅	うめ	매실	
裏口	うらぐち	뒷문	
恨み	うらみ	"원한, 앙심"	
売り出し	うりだし	매출	
雨量	うりょう	강우량	
憂い	うれい	"근심, 걱정"	
売れ行き	うれゆき	팔림새	
運	うん	"운, 운명"	
運河	うんが	운하	
運勢	うんせい	운세	
運用	うんよう	운용	
永遠	えいえん	영원	
影響	えいきょう	영향	
栄光	えいこう	영광	
英字	えいじ	"영자, 영문자"	
映写	えいしゃ	영사	
衛生	えいせい	위생	
映像	えいぞう	영상	
英文	えいぶん	영문	
栄養	えいよう	영양	
栄養分	えいようぶん	영양분	
英和	えいわ	"영일, 영어와 일본어"	
液	えき	"액, 즙, 액체"	
えさ		먹이	
枝葉	えだは	"지엽, 사소한 일"	
宴会	えんかい	"연회, 잔치"	
延期	えんき	"연기, 미룸"	
園芸	えんげい	원예	
演劇	えんげき	연극	
円周	えんしゅう	"원주, 원둘레"	
演習	えんしゅう	연습	
円熟	えんじゅく	원숙	
演出	えんしゅつ	연출	
煙突	えんとつ	굴뚝	
遠慮	えんりょ	"사양, 삼감"	
おい		조카	
王	おう	왕	
応急	おうきゅう	응급	
王様	おうさま	임금님	
王子	おうじ	왕자	
王女	おうじょ	공주	
往生	おうじょう	"체념, 단념, 난감함"	
応接	おうせつ	"응접, 접대"	
応答	おうとう	응답	
大通り	おおどおり	"(시내의) 큰길, 대로"	
大家	おおや	집주인	
丘	おか	"언덕, 작은 산"	
お菓子	おかし	과자	
沖	おき	먼 바다	
奥	おく	(깊숙한) 안쪽	
奥様	おくさま	"사모님, 안주인"	
遅れ	おくれ	늦음	
行い	おこない	"행실, 행동"	
お辞儀	おじぎ	"(머리 숙여) 절함, 인사함"	
汚染	おせん	오염	
夫	おっと	남편	
お手伝いさん	おてつだいさん	가사도우미	
落とし物	おとしもの	분실물	
驚き	おどろき	놀람	
鬼	おに	귀신	
おのおの		"각자, 각각"	
帯	おび	띠	
覚え	おぼえ	"기억, 경험, 이해"	
お参り	おまいり	"신불을 참배하러 감, 참배"	
思いつき	おもいつき	"문득 생각이 남, 착상"	
思い出	おもいで	추억	
おやつ		(오후에 먹는) 간식	
親指	おやゆび	"엄지손가락, 엄지발가락"	
織物	おりもの	직물	
恩	おん	은혜	
恩恵	おんけい	은혜	
温室	おんしつ	온실	
温帯	おんたい	온대	
温暖化	おんだんか	온난화	
御中	おんちゅう	"귀중, 귀하"	
温度	おんど	온도	
蚊	か	모기	
貝	かい	"조개, 조가비"	
害	がい	"해, 손해"	
会員	かいいん	회원	
開演	かいえん	"개연, 공연을 시작함"	
開花	かいか	개화	
絵画	かいが	회화	
開会	かいかい	개회	
海外	かいがい	해외	
会館	かいかん	회관	
会計	かいけい	회계	
開講	かいこう	개강	
会合	かいごう	회합	
外交	がいこう	외교	
開始	かいし	개시	
解釈	かいしゃく	해석	
海水浴	かいすいよく	해수욕	
回数	かいすう	횟수	
快晴	かいせい	쾌청	
回送	かいそう	회송	
開通	かいつう	개통	
改定	かいてい	개정	
回転	かいてん	회전	
外電	がいでん	"외신, 외전"	
街道	かいどう	"가도, 간선도로"	
街頭	がいとう	"가두, 길거리"	
街灯	がいとう	"가등, 가로등"	
外套	がいとう	외투	
該当	がいとう	해당	
外部	がいぶ	외부	
開封	かいふう	개봉	
開放	かいほう	개방	
解放	かいほう	해방	
海洋	かいよう	해양	
改良	かいりょう	개량	
概論	がいろん	개론	
家屋	かおく	가옥	
香り	かおり	"향기, 좋은 냄새"	
画家	がか	화가	
化学	かがく	화학	
係員	かかりいん	담당자	
書留	かきとめ	등기	
書き取り	かきとり	"베껴 씀, 받아쓰기"	
垣根	かきね	울타리	
書き物	かきもの	"문서, 글을 씀"	
～限り	～かぎり	~(인/하는) 한	
学	がく	학문	
各位	かくい	"각위, 여러분"	
学位	がくい	학위	
架空	かくう	가공	
格言	かくげん	격언	
各自	かくじ	각자	
学士	がくし	학사	
学者	がくしゃ	학자	
学術	がくじゅつ	학술	
各人	かくじん	각자	
各設	かくせつ	각각의 가설	
確認	かくにん	확인	
学年	がくねん	학년	
学問	がくもん	학문	
確率	かくりつ	확률	
学力	がくりょく	학력	
学歴	がくれき	학력	
陰	かげ	그늘	
影	かげ	그림자	
掛け算	かけざん	곱셈	
過去	かこ	과거	
かご		바구니	
火口	かこう	"화구, 화산의 분화구"	
化合	かごう	화합	
火災	かさい	화재	
飾り	かざり	"꾸밈, 장식"	
貸し	かし	빌려 줌	
家事	かじ	"가사, 집안일"	
過失	かしつ	과실	
果実	かじつ	"과실, 열매"	
貸間	かしま	셋방	
歌手	かしゅ	가수	
課税	かぜい	과세	
下線	かせん	밑줄	
加速	かそく	가속	
加速度	かそくど	가속도	
型	かた	"본, 거푸집, 틀, 형식"	
方々	かたがた	여러분	
刀	かたな	"칼, 검"	
かたまり		"덩어리, 뭉치"	
価値	かち	가치	
学科	がっか	학과	
学会	がっかい	학회	
学期	がっき	학기	
楽器	がっき	악기	
学級	がっきゅう	학급	
括弧	かっこ	괄호	
各国	かっこく	각국	
活字	かつじ	활자	
活用	かつよう	활용	
活力	かつりょく	활력	
課程	かてい	(교육) 과정	
過程	かてい	"과정, 프로세스"	
仮名	かな	가나(일본 문자)	
仮名遣い	かなづかい	かな 표기법	
鐘	かね	종	
加熱	かねつ	가열	
過半数	かはんすう	과반수	
かび		곰팡이	
株	かぶ	"그루, 포기, 주식"	
かま		"솥, 가마"	
神	かみ	신	
紙くず	かみくず	휴지	
かみそり		면도칼	
雷	かみなり	"천둥, 우레, 벼락"	
髪の毛	かみのけ	"머리털, 머리카락"	
歌謡	かよう	가요	
殻	から	"껍질, 껍데기"	
柄	がら	"몸집, 품위, 무늬"	
空っぽ	からっぽ	텅 빔	
かるた		"놀이딱지, 놀이카드"	
革	かわ	가죽	
為替	かわせ	외환	
かわら		기와	
缶	かん	"캔, 통조림"	
勘	かん	"직감, 육감"	
簡易	かんい	간이	
間隔	かんかく	간격	
換気	かんき	환기	
観客	かんきゃく	관객	
感激	かんげき	감격	
関西	かんさい	관서	
観察	かんさつ	관찰	
元日	がんじつ	"새해 첫날, 1월 1일"	
患者	かんじゃ	환자	
鑑賞	かんしょう	감상	
感情	かんじょう	감정	
間接	かんせつ	간접	
寒帯	かんたい	한대	
勘違い	かんちがい	착각	
缶詰	かんづめ	통조림	
乾電池	かんでんち	건전지	
関東	かんとう	관동	
感動	かんどう	감동	
監督	かんとく	감독	
乾杯	かんぱい	건배	
看板	かんばん	간판	
看病	かんびょう	간병	
冠	かんむり	(머리에 쓰는) 관	
関連	かんれん	관련	
緩和	かんわ	완화	
気圧	きあつ	기압	
議員	ぎいん	의원	
機械	きかい	기계	
器械	きかい	기계	
機会	きかい	기회	
議会	ぎかい	의회	
機関	きかん	기관	
機関車	きかんしゃ	기관차	
機関銃	きかんじゅう	기관총	
聞き取り	ききとり	듣고 이해함	
飢饉	ききん	기근	
器具	きぐ	기구	
期限	きげん	기한	
記号	きごう	기호	
生地	きじ	"옷감, 천"	
記事	きじ	기사	
技師	ぎし	"기사, 기술자"	
儀式	ぎしき	의식	
期日	きじつ	기일	
記者	きしゃ	기자	
規準	きじゅん	"규준, 규범, 기준"	
起床	きしょう	기상	
気性	きしょう	"기질, 성질"	
奇数	きすう	"기수, 홀수"	
帰宅	きたく	귀가	
基地	きち	기지	
議長	ぎちょう	의장	
貴重品	きちょうひん	귀중품	
喫茶	きっさ	차를 마심	
きつね		여우	
気迫	きはく	기백	
基盤	きばん	기반	
希望	きぼう	희망	
基本	きほん	기본	
記名	きめい	기명	
義務	ぎむ	의무	
逆	ぎゃく	"역, 반대"	
客席	きゃくせき	객석	
客間	きゃくま	"응접실, 객실"	
級	きゅう	"급, 등급, 단계"	
球	きゅう	"구, 공"	
休暇	きゅうか	휴가	
休学	きゅうがく	휴학	
休憩	きゅうけい	"휴게, 휴식"	
休講	きゅうこう	휴강	
休日	きゅうじつ	휴일	
吸収	きゅうしゅう	흡수	
急所	きゅうしょ	"급소, 핵심"	
救助	きゅうじょ	구조	
給与	きゅうよ	"급여, 급료"	
休養	きゅうよう	휴양	
教員	きょういん	"교원, 교사"	
強化	きょうか	강화	
境界	きょうかい	경계	
共学	きょうがく	공학	
教科書	きょうかしょ	교과서	
競技	きょうぎ	경기	
行儀	ぎょうぎ	"예의범절, 행동거지"	
供給	きょうきゅう	공급	
教材	きょうざい	교재	
教授	きょうじゅ	교수	
恐縮	きょうしゅく	"황송함, 죄송함"	
強調	きょうちょう	강조	
強風	きょうふう	강풍	
教養	きょうよう	교양	
行列	ぎょうれつ	행렬	
曲線	きょくせん	곡선	
霧	きり	안개	
規律	きりつ	"규율, 질서"	
気力	きりょく	"기력, 기백"	
きれ		"조각, 직물, 옷감"	
禁煙	きんえん	금연	
金魚	きんぎょ	금붕어	
金庫	きんこ	금고	
均衡	きんこう	균형	
禁止	きんし	금지	
近視	きんし	근시	
金銭	きんせん	금전	
金属	きんぞく	금속	
近代	きんだい	근대	
緊張	きんちょう	긴장	
筋肉	きんにく	근육	
勤務	きんむ	근무	
金融	きんゆう	금융	
句	く	"글귀, 구절"	
くい		말뚝	
空間	くうかん	공간	
偶数	ぐうすう	"우수, 짝수"	
空想	くうそう	공상	
空中	くうちゅう	공중	
区画	くかく	구획	
区間	くかん	구간	
くぎ		못	
区切り	くぎり	단락	
鎖	くさり	쇠사슬	
くし		빗	
くしゃみ		재채기	
苦心	くしん	고심	
くず		"쓰레기, 찌꺼기"	
薬指	くすりゆび	약지	
くせ		"버릇, 습관"	
管	くだ	"관, 대롱"	
具体化	ぐたいか	구체화	
下り	くだり	내려감	
唇	くちびる	입술	
口紅	くちべに	"입술 연지, 립스틱"	
苦痛	くつう	고통	
句読点	くとうてん	"구두점, 마침표와 쉼표"	
工夫	くふう	"궁리, 연구"	
区分	くぶん	구분	
区別	くべつ	구별	
組み合わせ	くみあわせ	"짜맞춤, 조합, 편성"	
位	くらい	"지위, 계급"	
暮らし	くらし	"살림, 생계, 일상생활"	
暮れ	くれ	"저묾, 저물 때"	
黒字	くろじ	흑자	
訓	くん	"훈, 가르침"	
軍	ぐん	"군, 군대"	
群	ぐん	"군, 무리, 떼"	
軍隊	ぐんたい	군대	
計	けい	"계, 합계"	
敬意	けいい	경의	
経営	けいえい	경영	
敬具	けいぐ	경구(편지 끝에 쓰는 말)	
稽古	けいこ	"(학문, 예능 따위를) 배움"	
敬語	けいご	경어	
傾向	けいこう	경향	
蛍光灯	けいこうとう	형광등	
警告	けいこく	경고	
掲載	けいさい	게재	
経済	けいざい	경제	
警察	けいさつ	경찰	
計算	けいさん	계산	
刑事	けいじ	형사	
毛糸	けいと	털실	
軽度	けいど	경도	
競馬	けいば	경마	
経費	けいひ	경비	
景品	けいひん	경품	
契約	けいやく	계약	
経由	けいゆ	경유	
形容詞	けいようし	형용사	
形容動詞	けいようどうし	형용동사	
毛皮	けがわ	모피	
劇	げき	극	
劇場	げきじょう	극장	
激増	げきぞう	"격증, 급증"	
下車	げしゃ	하차	
化粧	けしょう	화장	
下水	げすい	하수	
けた		(숫자의) 자릿수	
げた		나막신	
血液	けつえき	혈액	
月給	げっきゅう	월급	
傑作	けっさく	걸작	
決断	けつだん	결단	
決定	けってい	결정	
欠点	けってん	결점	
血統	けっとう	혈통	
月末	げつまつ	월말	
解熱	げねつ	해열	
検閲	けんえつ	검열	
原稿	げんこう	원고	
検索	けんさく	검색	
原産	げんさん	원산	
原始	げんし	원시	
現実	げんじつ	현실	
研修	けんしゅう	연수	
減少	げんしょう	감소	
現状	げんじょう	"현상, 현 상황"	
検診	けんしん	검진	
謙遜	けんそん	겸손	
建築	けんちく	건축	
建築家	けんちくか	건축가	
限度	げんど	한도	
現場	げんば	현장	
顕微鏡	けんびきょう	현미경	
憲法	けんぽう	헌법	
権利	けんり	권리	
原理	げんり	원리	
減量	げんりょう	감량	
原料	げんりょう	원료	
粉	こ・こな	"가루, 분말, 밀가루"	
語	ご	"말, 언어, 말씨"	
碁	ご	바둑	
恋	こい	"사랑, 연애"	
考案	こうあん	고안	
行為	こうい	행위	
合意	ごうい	합의	
工員	こういん	"공장 직원, 공장 노동자"	
幸運	こううん	행운	
公演	こうえん	공연	
効果	こうか	효과	
豪華	ごうか	호화	
公開	こうかい	공개	
工学	こうがく	공학	
交換	こうかん	교환	
航空	こうくう	항공	
光景	こうけい	광경	
工芸	こうげい	공예	
攻撃	こうげき	공격	
孝行	こうこう	"효행, 효도"	
交差	こうさ	교차	
鉱山	こうざん	광산	
口実	こうじつ	구실	
校舎	こうしゃ	"교사, 학교 건물"	
後者	こうしゃ	후자	
公衆	こうしゅう	공중	
工場	こうじょう・こうば	공장	
香水	こうすい	향수	
構成	こうせい	구성	
功績	こうせき	공적	
光線	こうせん	광선	
高速	こうそく	고속	
公団	こうだん	공단	
耕地	こうち	"경지, 경작지"	
交通機関	こうつうきかん	교통기관	
校庭	こうてい	교정	
肯定	こうてい	긍정	
高度	こうど	고도	
強盗	ごうとう	강도	
公認	こうにん	공인	
光熱費	こうねつひ	광열비	
効能	こうのう	효능	
後半	こうはん	후반	
公表	こうひょう	공표	
交付	こうふ	교부	
鉱物	こうぶつ	광물	
候補	こうほ	후보	
項目	こうもく	항목	
公用	こうよう	공용	
紅葉	こうよう・もみじ	단풍	
効用	こうよう	효용	
合理	ごうり	합리	
公立	こうりつ	공립	
交流	こうりゅう	교류	
合流	ごうりゅう	합류	
考慮	こうりょ	고려	
効力	こうりょく	효력	
高齢	こうれい	고령	
誤解	ごかい	오해	
語学	ごがく	어학	
呼吸	こきゅう	호흡	
故郷	こきょう	고향	
国王	こくおう	국왕	
国籍	こくせき	국적	
国定	こくてい	국정	
国土	こくど	국토	
告発	こくはつ	고발	
穀物	こくもつ	곡물	
国立	こくりつ	국립	
小言	こごと	잔소리	
心当たり	こころあたり	"짐작, 짐작 가는 곳"	
こじき		"거지, 비렁뱅이"	
こしょう		후추	
個性	こせい	개성	
国境	こっきょう	국경	
古典	こてん	고전	
琴	こと	거문고	
語頭	ごとう	어두	
言葉遣い	ことばづかい	"말씨, 말투"	
ことわざ		속담	
語尾	ごび	어미	
こぶ		혹	
こぶさた		"격조함, 무소식"	
小麦	こむぎ	밀	
小屋	こや	"작은 집, 오두막집"	
小指	こゆび	"새끼손가락, 새끼발가락"	
ご覧	ごらん	보심	
孤立	こりつ	고립	
紺	こん	"감색, 남색"	
根気	こんき	끈기	
今後	こんご	"앞으로, 이후"	
混合	こんごう	혼합	
根性	こんじょう	근성	
献立	こんだて	"식단, 메뉴"	
今日	こんにち	"금일, 오늘날"	
婚約	こんやく	약혼	
差	さ	"차, 차이"	
際	さい	"때, 기회, 경우"	
在学	ざいがく	재학	
在庫	ざいこ	재고	
財産	ざいさん	재산	
祭日	さいじつ	국경일	
再生	さいせい	재생	
最善	さいぜん	최선	
最大	さいだい	최대	
最低	さいてい	최저	
採点	さいてん	채점	
災難	さいなん	재난	
再発	さいはつ	재발	
裁縫	さいほう	"재봉, 바느질"	
材木	ざいもく	"재목, 목재"	
採用	さいよう	채용	
境	さかい	"경계, 갈림길"	
酒場	さかば	"술집, 주점"	
盛り	さかり	한창(때)	
さきおととい		그끄저께	
先々	さきざき	"먼 장래, 도처"	
索引	さくいん	색인	
作者	さくしゃ	작자	
作製	さくせい	"제작, 만듦"	
作物	さくもつ	"작물, 농작물"	
さじ		숟가락	
座敷	ざしき	"다다미방, 객실"	
刺身	さしみ	생선회	
札	さつ	지폐	
雑音	ざつおん	잡음	
作家	さっか	작가	
札束	さつたば	"돈다발, 돈뭉치"	
砂漠	さばく	사막	
さび		녹	
座布団	ざぶとん	방석	
左右	さゆう	"좌우, 좌지우지"	
猿	さる	원숭이	
騒ぎ	さわぎ	"소동, 소란"	
参観	さんかん	참관	
賛成	さんせい	찬성	
酸性	さんせい	산성	
酸素	さんそ	산소	
山林	さんりん	산림	
詩	し	시	
仕上がり	しあがり	"완성, 됨됨이"	
仕上げ	しあげ	"마무리, 완성"	
しあさって		글피	
自衛	じえい	자위	
視界	しかい	"시계, 시야"	
四角	しかく	"사각형, 네모꼴"	
資格	しかく	자격	
式	しき	식	
四季	しき	"사계, 사계절, 사철"	
時期	じき	"시기, 때"	
敷地	しきち	"부지, 대지"	
支給	しきゅう	지급	
事業	じぎょう	사업	
資源	しげん	자원	
自己	じこ	자기	
事項	じこう	사항	
視察	しさつ	시찰	
自殺	じさつ	자살	
持参	じさん	지참	
事実	じじつ	사실	
磁石	じしゃく	자석	
始終	しじゅう	"시종일관, 자초지종"	
自習	じしゅう	자습	
支出	ししゅつ	지출	
市場	しじょう	시장	
詩人	しじん	시인	
自身	じしん	"자신, 자기"	
自信	じしん	자신	
地震	じしん	지진	
事前	じぜん	사전	
自然科学	しぜんかがく	자연과학	
思想	しそう	사상	
時速	じそく	시속	
持続	じぞく	지속	
子孫	しそん	자손	
死体	したい	"사체, 시체"	
次第	しだい	순서	
事態	じたい	사태	
字体	じたい	서체	
下書き	したがき	"초고, 초안"	
自宅	じたく	자택	
下町	したまち	번화가	
自治	じち	자치	
室	しつ	방	
質	しつ	질	
実感	じっかん	실감	
湿気	しっけ	습기	
実現	じつげん	실현	
実験	じっけん	실험	
実習	じっしゅう	실습	
実地	じっち	"현장, 실제"	
執筆	しっぴつ	집필	
実物	じつぶつ	실물	
しっぽ		꼬리	
実務	じつむ	실무	
実例	じつれい	"실례, 실제 사례"	
失恋	しつれん	실연	
指定	してい	지정	
私鉄	してつ	"사철, 민간 철도"	
芝居	しばい	"연극, 연기"	
始発	しはつ	"시발, 처음 떠남, 처음 생김"	
死亡	しぼう	사망	
芝生	しばふ	잔디밭	
地盤	じばん	지반	
紙幣	しへい	지폐	
資本	しほん	자본	
しま		줄무늬	
しまい		"끝, 마지막"	
姉妹	しまい	자매	
事務	じむ	사무	
使命	しめい	사명	
地面	じめん	지면	
霜	しも	서리	
下	しも	"아래, 밑 하류"	
社会科学	しゃかいかがく	사회과학	
蛇口	じゃぐち	수도꼭지	
車庫	しゃこ	차고	
車掌	しゃしょう	차장	
写生	しゃせい	사생	
社説	しゃせつ	사설	
借金	しゃっきん	빚	
しゃっくり		딸꾹질	
車輪	しゃりん	"차륜, 수레 바퀴"	
じゃんけん		가위바위보	
週	しゅう	"주, 7일간"	
州	しゅう	주(행정구역의 하나)	
銃	じゅう	총	
集会	しゅうかい	집회	
習慣	しゅうかん	"습관, 관습"	
住居	じゅうきょ	주거	
宗教	しゅうきょう	종교	
集金	しゅうきん	수금	
集計	しゅうけい	집계	
集合	しゅうごう	집합	
習字	しゅうじ	"습자, 글자 쓰기를 익힘"	
修正	しゅうせい	수정	
修繕	しゅうぜん	"수선, 수리"	
充足	じゅうそく	충족	
重体	じゅうたい	중태	
住宅	じゅうたく	주택	
じゅうたん		"융단, 양탄자"	
集中	しゅうちゅう	집중	
終点	しゅうてん	종점	
重点	じゅうてん	중점	
就任	しゅうにん	취임	
周辺	しゅうへん	주변	
住民	じゅうみん	주민	
修了	しゅうりょう	수료	
重量	じゅうりょう	중량	
重力	じゅうりょく	중력	
主演	しゅえん	주연	
主観	しゅかん	주관	
主義	しゅぎ	주의	
熟語	じゅくご	숙어	
祝日	しゅくじつ	국경일	
縮小	しゅくしょう	축소	
主語	しゅご	주어	
手術	しゅじゅつ	수술	
首相	しゅしょう	수상	
主食	しゅしょく	주식	
主人公	しゅじんこう	주인공	
主体	しゅたい	주체	
主題	しゅだい	주제	
主張	しゅちょう	주장	
出演	しゅつえん	출연	
出勤	しゅっきん	출근	
出血	しゅっけつ	출혈	
出現	しゅつげん	출현	
述語	じゅつご	"술어, 서술어"	
出産	しゅっさん	출산	
出社	しゅっしゃ	출근	
出場	しゅつじょう	출장	
出生	しゅっしょう	출생	
出題	しゅつだい	출제	
出動	しゅつどう	출동	
出費	しゅっぴ	"출비, 지출"	
出品	しゅっぴん	출품	
主任	しゅにん	주임	
主婦	しゅふ	주부	
需要	じゅよう	수요	
主力	しゅりょく	주력	
受話器	じゅわき	수화기	
瞬間	しゅんかん	순간	
循環	じゅんかん	순환	
巡査	じゅんさ	순경	
順序	じゅんじょ	순서	
純情	じゅんじょう	순정	
順番	じゅんばん	"순번, 순서, 차례"	
仕様	しよう	"방법, 도리"	
使用	しよう	사용	
賞	しょう	상	
章	しょう	장	
上位	じょうい	상위	
上映	じょうえい	상영	
上演	じょうえん	상연	
消化	しょうか	소화	
障害	しょうがい	"장해, 장애"	
将棋	しょうぎ	장기	
定規	じょうぎ	"자, 기준"	
上京	じょうきょう	상경	
賞金	しょうきん	상금	
上空	じょうくう	"상공, 하늘"	
上下	じょうげ	상하	
衝撃	しょうげき	충격	
条件	じょうけん	조건	
正午	しょうご	정오	
詳細	しょうさい	자세한 내용	
障子	しょうじ	"장지, 미닫이(문)"	
常識	じょうしき	상식	
商社	しょうしゃ	상사	
乗車券	じょうしゃけん	승차권	
上旬	じょうじゅん	상순	
情勢	じょうせい	정세	
状態	じょうたい	상태	
上達	じょうたつ	"기능이 향상됨, 숙달"	
冗談	じょうだん	농담	
消毒	しょうどく	소독	
使用人	しようにん	"피고용인, 이용자"	
商人	しょうにん	상인	
勝敗	しょうはい	승패	
商売	しょうばい	장사	
蒸発	じょうはつ	증발	
消費者	しょうひしゃ	소비자	
商品	しょうひん	상품	
勝負	しょうぶ	"승부, 승패"	
小便	しょうべん	소변	
消防	しょうぼう	소방	
正味	しょうみ	"알맹이, 정량, 실제"	
正面	しょうめん	정면	
消耗	しょうもう	소모	
将来	しょうらい	장래	
勝利	しょうり	승리	
初級	しょきゅう	초급	
助教授	じょきょうじゅ	조교수	
職	しょく	"직, 직책"	
職員	しょくいん	직원	
食塩	しょくえん	식염	
食卓	しょくたく	식탁	
職人	しょくにん	"직공, 장인"	
植物	しょくぶつ	식물	
食物	しょくもつ	"식품, 음식물"	
食料	しょくりょう	"식품, 식대, 식비"	
食糧	しょくりょう	식량	
書斎	しょさい	서재	
助手	じょしゅ	"조수, (대학) 조교"	
初旬	しょじゅん	"초순, 상순"	
書籍	しょせき	서적	
所属	しょぞく	소속	
書道	しょどう	"서도, 서예"	
所得	しょとく	소득	
書物	しょもつ	"서책, 책, 도서"	
白髪	しらが	백발	
知らせ	しらせ	"알림, 통지"	
調べ	しらべ	"조사, 심문"	
尻	しり	엉덩이	
自立	じりつ	자립	
汁	しる	"즙, 물"	
印	しるし	"표시, 표지"	
城	しろ	성	
素人	しろうと	"초심자, 풋내기"	
しわ		"주름, 구김살"	
芯	しん	"심, 심지"	
人格	じんかく	인격	
心境	しんきょう	"심경, 마음"	
真空	しんくう	진공	
神経	しんけい	신경	
信仰	しんこう	신앙	
進行	しんこう	진행	
人工	じんこう	인공	
申告	しんこく	신고	
人材	じんざい	인재	
診察	しんさつ	진찰	
人事	じんじ	인사	
信者	しんじゃ	신자	
進出	しんしゅつ	진출	
心身	しんしん	심신	
親戚	しんせき	친척	
新設	しんせつ	새로운 학설	
人造	じんぞう	인조	
寝台	しんだい	침대	
振動	しんどう	진동	
進入	しんにゅう	진입	
侵入	しんにゅう	침입	
審判	しんぱん	심판	
人物	じんぶつ	인물	
人文科学	じんぶんかがく	인문과학	
進歩	しんぽ	진보	
人命	じんめい	인명	
新友	しんゆう	"친우, 친한 벗"	
心理	しんり	심리	
森林	しんりん	"삼림, 숲"	
親類	しんるい	"친척, 일가"	
人類学	じんるいがく	인류학	
針路	しんろ	"항로, 진로"	
神話	しんわ	신화	
酢	す	"초, 식초"	
図	ず	"그림, 도면"	
水産	すいさん	수산	
炊事	すいじ	취사	
水準	すいじゅん	수준	
水蒸気	すいじょうき	수증기	
水素	すいそ	수소	
推定	すいてい	추정	
水筒	すいとう	수통	
随筆	ずいひつ	수필	
水分	すいぶん	수분	
水平	すいへい	수평	
水平線	すいへいせん	수평선	
睡眠	すいみん	"수면, 잠"	
水面	すいめん	수면	
末	すえ	"끝, 마지막"	
末っ子	すえっこ	막내	
姿	すがた	"모습, 자태, 모양"	
図鑑	ずかん	도감	
杉	すぎ	삼나무	
好き嫌い	すききらい	"호불호, 좋고 싫음"	
好き好き	すきずき	각자의 기호	
隙間	すきま	"(빈) 틈, 겨를, 짬"	
図形	ずけい	도형	
筋	すじ	"줄기, 줄거리, 힘줄"	
鈴	すず	방울	
頭痛	ずつう	두통	
頭脳	ずのう	두뇌	
図表	ずひょう	"도표, 그래프"	
相撲	すもう	스모(일본 씨름)	
寸法	すんぽう	"길이, 치수"	
生	せい	"생, 삶"	
姓	せい	"성, 성씨"	
性	せい	"성질, 성격, 성"	
正	せい	"올바름, 정도"	
税	ぜい	"세, 세금"	
正解	せいかい	정답	
税関	ぜいかん	세관	
世紀	せいき	세기	
請求	せいきゅう	청구	
税金	ぜいきん	세금	
生計	せいけい	생계	
製作	せいさく	"(물건, 상품) 제작"	
制作	せいさく	"(예술작품, 방송) 제작"	
正式	せいしき	정식	
性質	せいしつ	성질	
青春	せいしゅん	청춘	
青少年	せいしょうねん	청소년	
精神	せいしん	정신	
成人	せいじん	"성인, 어른"	
整数	せいすう	정수	
清掃	せいそう	청소	
成長	せいちょう	"생장, 성장"	
晴天	せいてん	"맑은 하늘, 맑은 날씨"	
成年	せいねん	성년	
生年月日	せいねんがっぴ	생년월일	
性能	せいのう	성능	
整備	せいび	정비	
政府	せいふ	정부	
性別	せいべつ	성별	
正方形	せいほうけい	"정방형, 정사각형"	
姓名	せいめい	"성명, 이름"	
声明	せいめい	"성명, 의견"	
制約	せいやく	"제약, 제한"	
生理	せいり	생리	
成立	せいりつ	성립	
勢力	せいりょく	세력	
西暦	せいれき	"서력, 서기"	
咳	せき	기침	
石炭	せきたん	석탄	
赤道	せきどう	적도	
石油	せきゆ	석유	
世帯	せたい	"세대, 가구"	
世代	せだい	세대	
説	せつ	"설, 주장, 의견"	
接近	せっきん	접근	
設計	せっけい	설계	
絶好	ぜっこう	"절호, 더 없이 좋음"	
接触	せっしょく	접촉	
設定	せってい	설정	
説得	せっとく	설득	
絶滅	ぜつめつ	"절멸, 멸종, 근절"	
設立	せつりつ	설립	
瀬戸物	せともの	도자기	
せりふ		"대사, 틀에 박힌 말"	
栓	せん	마개	
善	ぜん	"선, 올바르고 착함"	
全額	ぜんがく	전액	
選挙	せんきょ	선거	
専業	せんぎょう	전업	
前言	ぜんげん	"전언, 앞서 한 말"	
洗剤	せんざい	세제	
選出	せんしゅつ	선출	
前進	ぜんしん	전진	
扇子	せんす	쥘부채	
専制	せんせい	전제	
先々月	せんせんげつ	"지지난달, 전전달"	
先々週	せんせんしゅう	전전주	
先祖	せんぞ	선조	
専属	せんぞく	전속	
先端	せんたん	"첨단, 선두"	
先着	せんちゃく	선착	
先頭	せんとう	선두	
扇風機	せんぷうき	선풍기	
洗面	せんめん	세면	
専用	せんよう	전용	
線路	せんろ	선로	
象	ぞう	코끼리	
騒音	そうおん	소음	
増加	ぞうか	증가	
送金	そうきん	송금	
ぞうきん		걸레	
増減	ぞうげん	증감	
倉庫	そうこ	창고	
創作	そうさく	창작	
掃除	そうじ	청소	
葬式	そうしき	장례식	
造船	ぞうせん	조선	
想像	そうぞう	상상	
相続	そうぞく	상속	
増大	ぞうだい	증대	
送別	そうべつ	송별	
草履	ぞうり	"(일본) 짚신, 샌들"	
総理大臣	そうりだいじん	총리대신	
送料	そうりょう	"송료, 배송료, 운송료"	
測定	そくてい	측정	
測量	そくりょう	측량	
底	そこ	"바닥, 밑"	
素質	そしつ	소질	
祖先	そせん	"선조, 조상"	
続行	ぞっこう	속행	
袖	そで	소매	
そろばん		"주판, 계산, 이해타산"	
存在	そんざい	존재	
損失	そんしつ	손실	
存続	そんぞく	존속	
田	た	논	
台	だい	"대, 토대, 기초"	
退学	たいがく	퇴학	
大学院	だいがくいん	대학원	
大気	たいき	"대기, 공기"	
大工	だいく	목수	
体系	たいけい	체계	
対決	たいけつ	대결	
体験	たいけん	체험	
太鼓	たいこ	북	
対策	たいさく	대책	
大使	たいし	대사	
体重	たいじゅう	체중	
退出	たいしゅつ	퇴출	
対象	たいしょう	대상	
対照	たいしょう	대조	
大小	だいしょう	"대소, 크고 작음"	
退場	たいじょう	퇴장	
大豆	だいず	"대두, 콩"	
体制	たいせい	체제	
体積	たいせき	"체적, 부피"	
大戦	たいせん	대전	
体操	たいそう	체조	
態度	たいど	태도	
大統領	だいとうりょう	대통령	
対比	たいひ	"대비, 대조"	
代表	だいひょう	대표	
大部分	だいぶぶん	"대부분, 거의"	
逮捕	たいほ	체포	
大木	たいぼく	"거목, 큰 나무"	
代名詞	だいめいし	대명사	
太陽	たいよう	"태양, 해"	
代理	だいり	대리	
大陸	たいりく	대륙	
対話	たいわ	대화	
田植え	たうえ	"모내기, 이앙"	
楕円	だえん	타원	
宝	たから	"보물, 보배"	
滝	たき	폭포	
助け	たすけ	"도움, 구조"	
戦い	たたかい	"싸움, 전쟁"	
立場	たちば	"설 곳, 입장, 처지, 관점"	
脱線	だっせん	탈선	
脱退	だったい	탈퇴	
種	たね	"씨앗, 원인"	
束	たば	"다발, 묶음, 뭉치"	
足袋	たび	일본식 버선	
球	たま	"구, 공"	
玉	たま	"옥, 구슬"	
弾	たま	"총알, 탄알"	
試し	ためし	"시험, 시도"	
便り	たより	"소식, 정보"	
頼り	たより	"의지, 연고, 연줄"	
段	だん	"단, 계단"	
段階	だんかい	단계	
短期	たんき	단기	
炭鉱	たんこう	탄광	
誕生	たんじょう	탄생	
たんす		"옷장, 장롱"	
淡水	たんすい	"담수, 민물"	
断水	だんすい	단수	
単数	たんすう	단수	
短大	たんだい	전문대학	
団地	だんち	단지	
担当	たんとう	담당	
単独	たんどく	단독	
短編	たんぺん	단편	
田んぼ	たんぼ	논	
治安	ちあん	치안	
地域	ちいき	지역	
地下水	ちかすい	지하수	
地区	ちく	지구	
知事	ちじ	지사	
地質	ちしつ	지질	
知人	ちじん	지인	
知性	ちせい	지성	
地帯	ちたい	지대	
地点	ちてん	"지점, 곳"	
知能	ちのう	지능	
地平線	ちへいせん	지평선	
地名	ちめい	지명	
着陸	ちゃくりく	착륙	
中央	ちゅうおう	중앙	
中古	ちゅうこ	중고	
中旬	ちゅうじゅん	중순	
中心	ちゅうしん	중심	
中世	ちゅうせい	중세	
中途	ちゅうと	중도	
長期	ちょうき	장기	
彫刻	ちょうこく	조각	
調査	ちょうさ	조사	
長女	ちょうじょ	"장녀, 맏딸"	
調整	ちょうせい	조정	
ちょうだい		받음	
長短	ちょうたん	"장단, 길고 짧음, 장단점"	
頂点	ちょうてん	"정상, 꼭대기"	
長男	ちょうなん	"장남, 맏아들"	
長方形	ちょうほうけい	"장방형, 직사각형"	
調味料	ちょうみりょう	조미료	
調理	ちょうり	조리	
貯金	ちょきん	저금	
直後	ちょくご	"직후, 바로 뒤"	
直線	ちょくせん	직선	
直通	ちょくつう	직통	
直訳	ちょくやく	직역	
直流	ちょくりゅう	직류	
直角	ちょっかく	직각	
直径	ちょっけい	직경	
ちり紙	ちりがみ	"휴지, 화장지"	
通過	つうか	통과	
通貨	つうか	"통화, 유통 화폐"	
通信	つうしん	통신	
通帳	つうちょう	통장	
通訳	つうやく	통역	
通用	つうよう	통용	
通路	つうろ	통로	
突き当り	つきあたり	막다른 곳	
月日	つきひ	"세월, 시간, 월일, 날짜"	
作り	つくり	"만듦, 만듦새, 몸집"	
続き	つづき	"연결, 계속"	
勤め	つとめ	근무	
務め	つとめ	"할 일, 임무"	
綱	つな	밧줄	
翼	つばさ	날개	
粒	つぶ	"알, 낱알"	
罪	つみ	죄	
つめ		"손톱, 발톱"	
つや		"윤기, 광택"	
梅雨	つゆ・ばいう	장마	
強目	つよめ	강한 편임	
釣り	つり	낚시	
連れ	つれ	"동행, 한패"	
出会い・出合い	であい	우연히 만남	
提案	ていあん	제안	
定員	ていいん	정원	
低下	ていか	저하	
定価	ていか	정가	
定期券	ていきけん	정기권	
定休日	ていきゅうび	정기 휴일	
停車	ていしゃ	정차	
提出	ていしゅつ	제출	
定食	ていしょく	정식	
定着	ていちゃく	정착	
定年	ていねん	정년	
出入り	でいり	"출입, 드나듦"	
出入り口	でいりぐち	출입구	
停留所	ていりゅうじょ	정류장	
手入れ	ていれ	"고침, 손질함, 보살핌"	
敵	てき	적	
出来事	できごと	"(우발적인) 사건, 사고"	
適用	てきよう	적용	
手首	てくび	손목	
弟子	でし	제자	
手品	てじな	"요술, 속임수"	
手帳	てちょう	수첩	
鉄	てつ	"철, 쇠"	
哲学	てつがく	철학	
徹底	てってい	철저	
鉄道	てつどう	철도	
鉄砲	てっぽう	"총, 총포류"	
手ぬぐい	てぬぐい	수건	
手前	てまえ	바로 앞	
転換	てんかん	전환	
伝記	でんき	전기	
電球	でんきゅう	전구	
典型	てんけい	전형	
天候	てんこう	"기후, 날씨"	
天才	てんさい	천재	
天災	てんさい	"천재, 자연재해"	
電子	でんし	전자	
点字	てんじ	점자	
天井	てんじょう	천장	
転職	てんしょく	"전직, 이직"	
点数	てんすう	점수	
伝染	でんせん	전염	
電柱	でんちゅう	"전신주, 전봇대"	
天然	てんねん	천연	
電波	でんぱ	전파	
電流	でんりゅう	전류	
電力	でんりょく	전력	
堂	とう	"당, 무리"	
塔	とう	탑	
銅	どう	"동, 구리"	
答案	とうあん	답안(지)	
統一	とういつ	통일	
同格	どうかく	동격	
峠	とうげ	"고개, 고비"	
統計	とうけい	통계	
登校	とうこう	등교	
同行	どうこう	동행	
動作	どうさ	동작	
東西	とうざい	동서	
当時	とうじ	당시	
動詞	どうし	동사	
同時	どうじ	동시	
当日	とうじつ	당일	
投書	とうしょ	투서	
登場	とうじょう	등장	
当選	とうせん	당선	
逃走	とうそう	도주	
灯台	とうだい	등대	
道徳	どうとく	도덕	
盗難	とうなん	도난	
当番	とうばん	당번	
逃避	とうひ	도피	
投票	とうひょう	투표	
等分	とうぶん	등분	
灯油	とうゆ	등유	
東洋	とうよう	동양	
童謡	どうよう	동요	
同僚	どうりょう	동료	
動力	どうりょく	동력	
童話	どうわ	동화	
都会	とかい	"도회, 도시"	
毒	どく	독	
独身	どくしん	독신	
独占	どくせん	"독점, 독차지"	
特長	とくちょう	특별한 장점	
特売	とくばい	"특매, 특별히 싸게 팜"	
独立	どくりつ	독립	
床の間	とこのま	도코노마(일본식 방의 바닥 일부를 높게 만들어 장식품을 두는 곳)	
登山	とざん	등산	
年月	としつき	"연월, 세월"	
図書	としょ	도서	
都心	としん	도심	
土台	どだい	"토대, 기초"	
戸棚	とだな	찬장	
途端	とたん	"찰나, 바로 그 순간"	
土地	とち	"토지, 그 지방"	
虎	とら	"호랑이, 범"	
どんぶり		덮밥	
内線	ないせん	내선	
眺め	ながめ	"전망, 풍경"	
中指	なかゆび	"중지, 가운뎃손가락"	
仲良し	なかよし	사이가 좋음	
流れ	ながれ	"흐름, 물결, 중단"	
無し	なし	없음	
なぞ		"수수께끼, 불가사의"	
なぞなぞ		수수께끼(놀이)	
納得	なっとく	"납득, 이해"	
鍋	なべ	냄비	
悩み	なやみ	"괴로움, 고민"	
縄	なわ	"새끼, 포승줄"	
難関	なんかん	난관	
南極	なんきょく	남극	
南米	なんべい	남미	
南北	なんぼく	남북	
虹	にじ	무지개	
日常	にちじょう	일상	
日用品	にちようひん	"일상용품, 생필품"	
日光	にっこう	"일광, 햇볕"	
入手	にゅうしゅ	입수	
入賞	にゅうしょう	입상	
女房	にょうぼう	"처, 아내"	
任務	にんむ	임무	
任命	にんめい	임명	
布	ぬの	"직물, 포목"	
値	ね	"값, 가격, 값어치"	
値上がり	ねあがり	값이 오름	
願い	ねがい	"소원, 바람"	
値下がり	ねさがり	값이 내림	
ねずみ		쥐	
値段	ねだん	값	
熱帯	ねったい	열대	
熱中	ねっちゅう	열중	
値引	ねびき	"값을 깎음, 깎아 줌"	
寝巻	ねまき	잠옷	
根本	ねもと	"뿌리, 근본"	
狙い	ねらい	"겨냥, 목적"	
年間	ねんかん	연간	
年月	ねんげつ	"연월, 세월"	
年功序列	ねんこうじょれつ	연공서열	
年始	ねんし	"연시, 연초"	
年末	ねんまつ	연말	
野	の	"들, 들판"	
脳	のう	뇌	
能	のう	"능력, 효능"	
農家	のうか	농가	
農業	のうぎょう	농업	
農産物	のうさんぶつ	농산물	
農村	のうそん	농촌	
濃度	のうど	농도	
農民	のうみん	농민	
農薬	のうやく	농약	
能率	のうりつ	능률	
軒	のき	처마	
のこぎり		톱	
残り	のこり	"남은 것, 나머지"	
望み	のぞみ	"바람, 소망"	
上り	のぼり	"오름, 올라감"	
場	ば	"장소, 곳, 자리, 경우"	
灰	はい	재	
俳句	はいく	하이쿠(17음의 일본 전통시)	
拝啓	はいけい	배계(편지 첫머리에 쓰는 인사말)	
配置	はいち	배치	
売店	ばいてん	매점	
売買	ばいばい	매매	
俳優	はいゆう	배우	
配列	はいれつ	배열	
墓	はか	무덤	
博士	はかせ	박사	
はかり		저울	
吐き気	はきけ	구역질	
白紙	はくし	백지	
博物館	はくぶつかん	박물관	
歯車	はぐるま	톱니바퀴	
はさみ		가위	
破産	はさん	파산	
端	はし	"끝, 선단, 가장자리"	
はしご		사다리	
初め	はじめ	"처음, 최초"	
始め	はじめ	"(일의) 시작, 기원"	
柱	はしら	기둥	
はす		"비스듬함, 경사"	
旗	はた	"기, 깃발"	
肌	はだ	"피부, 살갗"	
裸	はだか	"알몸, 맨몸"	
肌着	はだぎ	"내의, 속옷"	
働き	はたらき	"활약, 활동, 작용, 기능"	
発汗	はっかん	발간	
罰金	ばっきん	벌금	
発言	はつげん	발언	
発車	はっしゃ	발차	
花束	はなたば	꽃다발	
花嫁	はなよめ	"신부, 새색시"	
羽	はね	"날개, 깃"	
ばね		"용수철, 스프링"	
幅	はば	"폭, 너비"	
歯磨き	はみがき	"양치(질), 치약"	
早口	はやくち	말이 빠름	
腹	はら	"배, 복부"	
原	はら	"들, 벌판"	
針金	はりがね	철사	
番	ばん	"순서, 차례"	
半径	はんけい	반경	
半減	はんげん	반감	
判子	はんこ	도장	
反抗	はんこう	반항	
万歳	ばんざい	만세	
判事	はんじ	판사	
万全	ばんぜん	만전	
番地	ばんち	번지	
半島	はんとう	반도	
犯人	はんにん	범인	
反発	はんぱつ	반발	
日当たり	ひあたり	"볕이 듦, 양지"	
被害	ひがい	피해	
日陰	ひかげ	"응달, 음지"	
引き算	ひきざん	"뺄셈, 감산"	
引き分け	ひきわけ	"비김, 무승부"	
飛行	ひこう	비행	
ひざ		무릎	
日差し・陽射し	ひざし	"햇살, 햇볕"	
ひじ		팔꿈치	
非常	ひじょう	"비상, 긴급사태"	
額	ひたい	이마	
筆記	ひっき	필기	
日付	ひづけ	"일자, 날짜"	
筆者	ひっしゃ	필자	
必需品	ひつじゅひん	필수품	
必須	ひっす	필수	
筆跡	ひっせき	필적	
否定	ひてい	부정	
一口	ひとくち	"한 입, 한마디 (말)"	
一言	ひとこと	"일언, 한마디 (말)"	
人込み	ひとごみ	"붐빔, 북적임"	
人通り	ひとどおり	사람의 왕래	
瞳	ひとみ	"눈동자, 동공"	
一休み	ひとやすみ	잠깐 쉼	
独り言	ひとりごと	"혼잣말, 독백"	
一人一人	ひとりひとり	"한 사람 한 사람, 개개인"	
非難	ひなん	비난	
避難	ひなん	피난	
日にち	ひにち	"날, 날짜"	
日の入り	ひのいり	"일몰, 해넘이"	
日の出	ひので	"일출, 해돋이"	
響き	ひびき	울림	
百科事典	ひゃっかじてん	백과사전	
美容	びよう	미용	
表	ひょう	표	
表紙	ひょうし	표지	
標準	ひょうじゅん	표준	
表情	ひょうじょう	표정	
病状	びょうじょう	병세	
平等	びょうどう	평등	
病人	びょうにん	"병자, 환자"	
標本	ひょうほん	표본	
評論	ひょうろん	평론	
疲労	ひろう	피로	
広さ	ひろさ	넓이	
広場	ひろば	광장	
品	ひん	"품격, 품질"	
瓶	びん	병	
便	びん	"나름, 이동수단"	
品質	ひんしつ	품질	
便せん	びんせん	편지지	
瓶詰め	びんづめ	병조림	
風習	ふうしゅう	풍습	
風船	ふうせん	"풍선, 기구"	
封筒	ふうとう	봉투	
不運	ふうん	불운	
笛	ふえ	피리	
不可	ふか	"옳지 않음, 불가능, 불합격"	
武器	ぶき	무기	
不況	ふきょう	불황	
付近	ふきん	부근	
不均衡	ふきんこう	불균형	
副詞	ふくし	부사	
複写	ふくしゃ	복사	
複数	ふくすう	복수	
服装	ふくそう	"복장, 옷차림"	
袋	ふくろ	"자루, 주머니"	
不景気	ふけいき	불경기	
不幸	ふこう	불행	
符号	ふごう	"부호, 표시"	
夫妻	ふさい	"부처, 부부"	
不在	ふざい	부재	
節	ふし	"마디, 절"	
武士	ぶし	무사	
部首	ぶしゅ	(한자의) 부수	
負傷	ふしょう	부상	
ふすま		맹장지	
不正	ふせい	"부정, 비리"	
付属	ふぞく	부속	
双子	ふたご	쌍둥이	
縁	ふち	"가장자리, 테두리"	
付着	ふちゃく	부착	
不通	ふつう	"불통, 두절"	
物質	ぶっしつ	물질	
物理	ぶつり	물리	
筆	ふで	붓	
不動	ふどう	"부동, 확고함"	
不動産	ふどうさん	부동산	
船便	ふなびん	"선편, 배편"	
部品	ぶひん	부품	
父母	ふぼ	부모	
不満	ふまん	"불만, 불만족"	
踏切	ふみきり	(철도의) 건널목	
舞踊	ぶよう	무용	
ふるさと		고향	
ふろしき		보자기	
雰囲気	ふんいき	분위기	
噴火	ふんか	분화	
分割	ぶんかつ	분할	
文芸	ぶんげい	문예	
文献	ぶんけん	문헌	
噴水	ふんすい	분수	
分数	ぶんすう	분수	
文体	ぶんたい	문체	
分配	ぶんぱい	분배	
分布	ぶんぷ	분포	
分別	ぶんべつ	분별	
文脈	ぶんみゃく	문맥	
文明	ぶんめい	문명	
分類	ぶんるい	분류	
塀	へい	담	
閉会	へいかい	폐회	
平行	へいこう	평행	
兵隊	へいたい	"군대, 병사"	
平野	へいや	평야	
へそ		배꼽	
別	べつ	"구별, 차이, 다름"	
別館	べっかん	별관	
別荘	べっそう	별장	
便	べん	"편의, 편리"	
変換	へんかん	변환	
変速	へんそく	변속	
法	ほう	"법, 법률"	
棒	ぼう	"몽둥이, 막대기"	
放映	ほうえい	방영	
望遠鏡	ぼうえんきょう	망원경	
防火	ぼうか	방화	
方角	ほうがく	"방위, 방향"	
法学	ほうがく	법학	
ほうき		"비, 빗자루"	
法規	ほうき	법규	
坊さん	ぼうさん	"스님, 중을 친숙하게 부름"	
防止	ぼうし	방지	
方式	ほうしき	방식	
包装	ほうそう	포장	
放送局	ほうそうきょく	방송국	
法則	ほうそく	법칙	
包帯	ほうたい	붕대	
包丁	ほうちょう	식칼	
方程式	ほうていしき	방정식	
防犯	ぼうはん	방법	
頬	ほお・ほほ	"볼, 뺨"	
牧場	ぼくじょう	목장	
牧畜	ぼくちく	목축	
保険	ほけん	보험	
保護	ほご	보호	
歩行	ほこう	보행	
ほこり		먼지	
誇り	ほこり	"자랑, 긍지"	
募集	ぼしゅう	모집	
北極	ほっきょく	북극	
坊ちゃん	ぼっちゃん	"도련님, 도령"	
仏	ほとけ	"부처, 불상"	
炎	ほのお	"불꽃, 불길"	
堀	ほり	"수로, 해자"	
ぼろ		"넝마, 누더기"	
盆	ぼん	쟁반	
本格	ほんかく	본격	
本館	ほんかん	본관	
本国	ほんごく	본국	
本質	ほんしつ	본질	
本体	ほんたい	본체	
盆地	ぼんち	분지	
本部	ほんぶ	본부	
本文	ほんぶん	본문	
本来	ほんらい	본래	
間	ま	"사이, 간격"	
迷子	まいご	미아	
枚数	まいすう	"매수, 장수"	
幕	まく	"막, 천막"	
枕	まくら	베개	
摩擦	まさつ	마찰	
待合室	まちあいしつ	대합실	
街角	まちかど	"길모퉁이, 길목"	
真っ先	まっさき	"맨 앞, 맨 먼저"	
まとまり		"합침, 통합, 정리"	
まとめ		"정리, 수습"	
真似	まね	흉내	
まぶた		눈꺼풀	
円	まる	"원형, 동그라미"	
回り道	まわりみち	길을 돌아서 감	
満員	まんいん	만원	
満席	まんせき	"만석, 만원"	
満足	まんぞく	만족	
満点	まんてん	만점	
身	み	"몸, 신체"	
実	み	"열매, 과실"	
見かけ	みかけ	"외관, 겉보기"	
三日月	みかづき	초승달	
みさき		"갑, 곶"	
水着	みずぎ	수영복	
店屋	みせや	"점포, 가게"	
味噌	みそ	된장	
蜜	みつ	꿀	
未定	みてい	미정	
実り	みのり	"결실, 수확"	
身分	みぶん	"신분, 지위"	
未満	みまん	미만	
身元	みもと	"신분, 신원"	
明後日	みょうごにち	모레	
魅力	みりょく	매력	
民間	みんかん	민간	
民謡	みんよう	민요	
無視	むし	무시	
無地	むじ	민무늬	
虫歯	むしば	충치	
胸	むね	"가슴, 마음"	
紫	むらさき	"자색, 보랏빛"	
芽	め	싹	
めい		조카딸	
名作	めいさく	명작	
明示	めいじ	명시	
迷信	めいしん	미신	
名人	めいじん	"명인, 명수"	
名物	めいぶつ	명물	
めいめい		"각자, 제각기, 각각"	
目覚まし	めざまし	잠을 깸	
飯	めし	"밥, 식사"	
目下	めした	아랫사람	
目印	めじるし	"표시, 표지"	
めまい		현기증	
目安	めやす	"목표, 기준"	
綿	めん	"면, 무명"	
免許	めんきょ	면허	
免税	めんぜい	면세	
面積	めんせき	면적	
申し訳	もうしわけ	"변명, 해명"	
木材	もくざい	"목재, 재목"	
目次	もくじ	"목차, 차례"	
餅	もち	떡	
持ち物	もちもの	"소지품, 소유물"	
元	もと	"처음, 기원"	
基	もと	"근본, 기초, 토대"	
物置	ものおき	"헛간, 광"	
物音	ものおと	(무언가의) 소리	
物真似	ものまね	흉내	
模様	もよう	"모양, 무늬"	
問答	もんどう	"문답, 묻고 답함"	
やかん		주전자	
夜間	やかん	야간	
訳	やく	"역, 번역"	
役	やく	"직무, 역할"	
役者	やくしゃ	"배우, 광대"	
役作り	やくづくり	배우가 배역에 대해 연구함	
役人	やくにん	"관리, 공무원"	
薬品	やくひん	약품	
役割	やくわり	"역할, 임무"	
やけど		"화상, 뎀"	
夜行	やこう	야행	
矢印	やじるし	화살표	
薬局	やっきょく	약국	
家主	やぬし	"집주인, 가장"	
夜分	やぶん	"밤, 밤중"	
遊園地	ゆうえんち	유원지	
夕刊	ゆうかん	석간	
友好	ゆうこう	우호	
友情	ゆうじょう	우정	
優先	ゆうせん	우선	
夕立	ゆうだち	(여름 오후의) 소나기	
夕日	ゆうひ	석양	
郵便局	ゆうびんきょく	우체국	
床	ゆか	마루	
浴衣	ゆかた	여름철에 입는 무명 홑옷	
湯気	ゆげ	"김, 수증기"	
輸血	ゆけつ	수혈	
輸出	ゆしゅつ	수출	
輸送	ゆそう	수송	
ゆとり		여유	
輸入	ゆにゅう	수입	
指先	ゆびさき	"손끝, 발끝"	
夜明け	よあけ	새벽	
用語	ようご	용어	
要旨	ようし	요지	
幼児	ようじ	유아	
要所	ようしょ	"요소, 요점, 요지"	
様子	ようす	"모양, 상황"	
養成	ようせい	양성	
要素	ようそ	요소	
幼稚園	ようちえん	유치원	
要点	ようてん	요점	
洋品店	ようひんてん	양품점	
養分	ようぶん	영양분	
羊毛	ようもう	"양모, 양털"	
要領	ようりょう	요령	
予期	よき	"예기, 예상"	
浴室	よくしつ	욕실	
予算	よさん	예산	
予想	よそう	예상	
四つ角	よつかど	"네 모퉁이, 교차로"	
酔っ払い	よっぱらい	"술주정꾼, 취객"	
夜中	よなか	한밤중	
予備	よび	예비	
余分	よぶん	여분	
予報	よほう	예보	
読み物	よみもの	읽을거리	
嫁	よめ	며느리	
余裕	よゆう	여유	
喜び	よろこび	기쁨	
弱み	よわみ	"취약점, 약점"	
四割引	よんわりびき	40% 할인	
来場	らいじょう	그 장소에 옴	
利害	りがい	"이해, 득실, 손익"	
陸	りく	"육지, 물"	
離婚	りこん	이혼	
利点	りてん	이점	
裏面	りめん	"이면, 뒷면"	
流域	りゅういき	유역	
流通	りゅうつう	유통	
両側	りょうがわ	양측	
漁師	りょうし	"고기잡이, 어부"	
領事	りょうじ	영사	
良心	りょうしん	양심	
両立	りょうりつ	양립	
旅客	りょかく	여객	
旅券	りょけん	여권	
離陸	りりく	이륙	
臨時	りんじ	임시	
類	るい	"종류, 같은 부류"	
零点	れいてん	"영점, 빙점"	
零度	れいど	섭씨 0도	
歴史	れきし	역사	
列島	れっとう	열도	
恋愛	れんあい	연애	
連合	れんごう	연합	
連想	れんそう	연상	
ろうそく		"초, 양초"	
労働	ろうどう	노동	
論文	ろんぶん	논문	
和英	わえい	일본어와 영어	
わき		"겨드랑이, 옆"	
綿	わた	"목화, 솜"	
和服	わふく	일본 옷	
割り算	わりざん	나눗셈	
悪口	わるくち・わるぐち	욕	
碗	わん	(음식물을 담는) 공기	
湾	わん	"만, 바다가 육지로 굽어 후미진 곳"	
遭う	あう	"(어떤 일을 우연히) 겪다, 당하다"	
あおぐ		"부채질하다, 부치다"	
空ける	あける	"비우다, 짬을 내다"	
あきらめる		"포기하다, 단념하다"	
あきる		"싫증나다, 물리다"	
あきれる		"어이없다, 기가 막히다"	
味わう	あじわう	"맛보다, 경험하다"	
預かる	あずかる	"맡다, (남의 것을) 보관하다"	
暖まる・温まる	あたたまる	따뜻해지다	
暖める・温める	あたためる	따뜻하게 하다	
暴れる	あばれる	"난폭하게 굴다, 날뛰다"	
あぶる		"(불에) 쬐어 굽다, 말리다"	
余る	あまる	남다	
過つ	あやまつ	"잘못하다, 실수하다"	
改める	あらためる	"고치다, 개선하다"	
著す	あらわす	"저술하다, 저작하다"	
荒れる	あれる	(날씨가) 거칠어지다	
嫌がる	いやがる	싫어하다	
いる		"볶다, 지지다"	
飢える	うえる	굶주리다	
浮かぶ	うかぶ	"뜨다, 떠오르다, 나타나다"	
浮かべる	うかべる	"떠올리다, 생각해 내다"	
承る	うけたまわる	받다・듣다・맡다의 겸양어	
失う	うしなう	잃다	
撃つ	うつ	"발사하다, 쏘다"	
討つ	うつ	"공격하다, 정벌하다"	
映す	うつす	"비치게 하다, 투영하다"	
訴える	うったえる	"소송하다, 호소하다"	
写る	うつる	"비치다, 보이다"	
うなる		"신음하다, 으르렁거리다"	
奪う	うばう	빼앗다	
埋まる	うまる	"메워지다, 막히다"	
埋める	うめる	"묻다, 메우다"	
敬う	うやまう	"존경하다, 공경하다"	
占う	うらなう	점치다	
恨む	うらむ	"원망하다, 분하게 여기다"	
描く	えがく	"그리다, 묘사하다"	
負う	おう	"짊어지다, 맡다"	
犯す	おかす	"범하다, 어기다"	
拝む	おがむ	공손히 절하다	
遅らす	おくらす	늦추다	
怠る	おこたる	"게으름을 피우다, 소홀히 하다"	
押さえる	おさえる	억누르다	
納まる	おさまる	"납입되다, 납부되다"	
収まる	おさまる	"수습되다, 해결되다"	
治まる	おさまる	"고요해지다, 진정되다"	
恐れる	おそれる	"두려워하다, 무서워하다"	
おどかす		"으르다, 위협하다"	
及ぶ	およぶ	"이르다, 미치다, 달하다"	
及ぼす	およぼす	"미치게 하다, 끼치다"	
下りる	おりる	"내리다, 내려가다"	
織る	おる	(옷감 등을) 짜다	
折る	おる	"접다, 꺾다, 굽히다"	
降ろす	おろす	"내리다, 내려뜨리다"	
卸す	おろす	도매로 팔다	
帰す	かえす	돌려보내다	
代える	かえる	대신하다	
返る	かえる	"되돌아가다, 되돌아오다"	
替える・換える	かえる	"바꾸다, 교환하다"	
欠かす	かかす	"빠뜨리다, 빼먹다, 거르다"	
かがむ		"굽다, 굽히다"	
輝く	かがやく	빛나다	
かかわる		"관계되다, 상관하다"	
限る	かぎる	"제한하다, 한정하다"	
かく		"긁다, 할퀴다, (땀을) 흘리다"	
かぐ		냄새 맡다	
隠れる	かくれる	"숨다, 숨어있다"	
かじる		"갉아먹다, 베어 먹다"	
科する	かする	"(형벌・벌금을) 내리다, 과하다"	
課する	かする	"부과하다, 시키다"	
稼ぐ	かせぐ	돈을 벌다	
固まる	かたまる	"굳다, 딱딱해지다"	
担ぐ	かつぐ	"메다, 짊어지다"	
兼ねる	かねる	겸하다	
かぶせる		"덮다, 씌우다"	
からかう		"조롱하다, 놀리다"	
刈る	かる	"베다, 깎다"	
枯れる	かれる	"(초목이) 마르다, 시들다"	
かわいがる		귀여워하다	
代わる	かわる	"대신하다, 대리하다"	
刻む	きざむ	"잘게 썰다, 새기다"	
築く	きずく	"쌓다, 구축하다"	
嫌う	きらう	싫어하다	
切れる	きれる	"떨어지다, 다 되다"	
腐る	くさる	"썩다, 상하다, 부패하다"	
崩す	くずす	"무너뜨리다, (큰 돈을) 헐다"	
崩れる	くずれる	"무너지다, 허물어지다"	
砕く	くだく	"깨뜨리다, 부수다"	
砕ける	くだける	"부서지다, 깨지다"	
下る	くだる	"내려가다, 내려오다"	
配る	くばる	"나누어 주다, 배포하다"	
汲む	くむ	"푸다, 퍼 올리다"	
酌む	くむ	(술 따위를) 따라서 마시다	
狂う	くるう	"미치다, 이상해지다"	
苦しめる	くるしめる	괴롭히다	
加える	くわえる	"가하다, 더하다, 보태다"	
加わる	くわわる	"가해지다, 더해지다, 늘다"	
蹴る	ける	"발로 차다, 걷어차다"	
被る	こうむる	"받다, 입다"	
超える	こえる	"(기준을) 넘다, 초과하다"	
焦がす	こがす	"눌리다, 태우다"	
こぐ		(노로 배를) 젓다	
凍える	こごえる	"얼다, 추위로 곱다"	
こしらえる		"마련하다, 만들다"	
こじらせる		"어렵게 하다, 악화시키다"	
こじれる		"복잡해지다, 악화되다"	
越す	こす	"넘다, 건너다, 이사하다"	
超す	こす	"넘다, 초과하다"	
こする		"문지르다, 비비다"	
好む	このむ	"좋아하다, 즐기다"	
こらえる		"참다, 견디다"	
転がす	ころがす	"굴리다, 쓰러뜨리다"	
転がる	ころがる	"구르다, 넘어지다"	
裂く	さく	"찢다, 쪼개다"	
探る	さぐる	"뒤지다, 더듬어 찾다"	
避ける	さける	"피하다, 꺼리다"	
下げる	さげる	"내리다, 숙이다"	
支える	ささえる	"떠받치다, 지탱하다"	
刺さる	ささる	"박히다, 찔리다"	
指す	さす	"가리키다, 지목하다"	
挿す	さす	"꽂다, 끼우다"	
刺す	さす	찌르다	
覚ます	さます	"깨다, 깨우다"	
冷ます	さます	식히다	
妨げる	さまたげる	방해하다	
覚める	さめる	"깨다, 눈이 뜨이다"	
冷める	さめる	식다	
去る	さる	"떠나다, 사라지다, 지나다"	
騒がす	さわがす	"소란을 피우다, 시끄럽게 하다"	
敷く	しく	"깔다, 설치하다"	
茂る	しげる	초목이 무성하다	
静まる	しずまる	"가라앉다, 안정되다"	
しぼむ		"시들다, 오므라들다"	
示す	しめす	"보이다, 나타내다, 가리키다"	
しゃがむ		"웅크리다, 쭈그리다"	
しゃぶる		입에 넣고 빨다	
記す	しるす	"적다, 기록하다"	
涼む	すずむ	바람을 쐬다	
済ませる	すませる	"마치다, 끝내다"	
澄む	すむ	"맑아지다, 말갛다"	
ずらす		비켜 놓다	
刷る	する	"인쇄하다, 찍다"	
ずれる		"어긋나다, 벗어나다"	
沿う	そう	따르다	
添う	そう	"꼭 붙어있다, 더해지다"	
注ぐ	そそぐ	"흘러 들어가다, 쏟아지다"	
そる		"깎다, 면도하다"	
それる		"빗나가다, 벗어나다"	
そろえる		"가지런히 하다, 갖추다"	
存じる・存ずる	ぞんじる・ぞんずる	알다・생각하다의 겸양어	
倒れる	たおれる	"쓰러지다, 넘어가다"	
耕す	たがやす	"경작하다, 일구다"	
抱く	だく	"안다, 껴안다"	
戦う	たたかう	"싸우다, 맞서다"	
叩く	たたく	"치다, 때리다, 두드리다"	
建つ	たつ	"세워지다, 서다"	
発つ	たつ	"출발하다, 떠나다"	
だます		속이다	
黙る	だまる	입을 다물다	
試す	ためす	"시험하다, 실제로 해보다"	
ためらう		"주저하다, 망설이다"	
足る	たる	"충분하다, 족하다"	
誓う	ちかう	"맹세하다, 서약하다"	
契る	ちぎる	"굳게 약속하다, 장래를 약속하다"	
縮れる	ちぢれる	"주름지다, 오그라들다"	
散らかる	ちらかる	"흩어지다, 어지러지다"	
散らす	ちらす	"흩뜨리다, 어지르다"	
散る	ちる	"떨어지다, 꽃잎이 지다"	
通じる	つうじる	"통하다, 정통하다, 내통하다"	
捕まる	つかまる	붙잡히다	
つかむ		"쥐다, 붙잡다"	
突く	つく	찌르다	
就く	つく	"자리에 오르다, 취임하다"	
注ぐ	つぐ	"쏟다, 붓다, 따르다"	
次ぐ	つぐ	"뒤를 잇다, 버금가다"	
尽くす	つくす	"다하다, 애쓰다"	
造る	つくる	"(건물・배) 만들다, 짓다"	
勤める	つとめる	"근무하다, 종사하다"	
つぶす		"(시간을) 때우다, 허비하다"	
つぶれる		"찌부러지다, 깨지다"	
詰める	つめる	"채우다, 막다, 좁히다"	
積もる	つもる	"쌓이다, 많이 모이다"	
強まる	つよまる	"강해지다, 세지다"	
強める	つよめる	"강하게 하다, 세게 하다"	
つる		매달다	
つるす		"달아매다, 매달다, 걸다"	
適する	てきする	"알맞다, 적당하다"	
照らす	てらす	(빛을) 비추다	
照る	てる	"빛나다, (날이) 개다"	
問う	とう	"묻다, 질문하다"	
通す	とおす	통과시키다	
溶かす	とかす	"녹이다, 풀다"	
尖る	とがる	"뾰족해지다, 예민해지다"	
解く	とく	(매듭・문제를) 풀다	
溶く	とく	"풀다, 개다, 녹이다"	
どく		"물러나다, 비키다"	
溶ける	とける	"녹다, 풀리다"	
解ける	とける	"풀리다, 끌러지다"	
どける		"치우다, 물리치다"	
閉じる	とじる	"닫다, 덮다, (눈을) 감다"	
とどまる		"머물다, 움직이지 않다"	
隣る	となる	"인접하다, 이웃하다"	
飛ばす	とばす	"날리다, 날게 하다"	
泊める	とめる	"묵게 하다, 숙박시키다"	
捕らえる	とらえる	"잡다, 붙잡다, 파악하다"	
採る	とる	"뽑다, 선택하다"	
捕る	とる	"잡다, 포획하다"	
流す	ながす	"흘리다, 흐르게 하다"	
眺める	ながめる	"바라보다, 전망하다"	
慰める	なぐさめる	"위로하다, 달래다"	
亡くす	なくす	"잃다, 여의다"	
殴る	なぐる	"세게 때리다, 세게 치다"	
成す	なす	"만들다, 이루다"	
なでる		"어루만지다, 쓰다듬다"	
怠ける	なまける	게으름 피우다	
鳴らす	ならす	"소리를 내다, 울리다"	
生る	なる	"(열매가) 열리다, 맺히다"	
煮える	にえる	"삶아지다, 익다"	
におう		"냄새가 나다, 향기가 나다"	
逃がす	にがす	"놓아주다, 놓치다"	
にらむ		"쏘아보다, 노려보다"	
煮る	にる	"삶다, 익히다"	
縫う	ぬう	"꿰매다, 바느질하다"	
抜く	ぬく	"빼다, 뽑다"	
濡らす	ぬらす	적시다	
寝かす・寝かせる	ねかす・ねかせる	"눕히다, 재우다"	
ねじる		"비틀다, 쥐어짜다"	
熱する	ねっする	"뜨거워지다, 뜨겁게 하다"	
狙う	ねらう	"겨누다, 노리다"	
のぞく		"엿보다, 들여다보다"	
望む	のぞむ	"바라다, 소망하다, 기대하다"	
伸ばす	のばす	"펴다, 늘리다"	
延ばす	のばす	"연장시키다, 연기하다"	
延びる	のびる	"길어지다, 연장되다"	
上る	のぼる	"오르다, 상경하다"	
昇る	のぼる	"(높은 지위에) 오르다, 하늘 높이 뜨다"	
這う	はう	기다	
生える	はえる	"(수염・초목 등) 나다, 자라다"	
はがす		"벗기다, 떼어내다"	
掃く	はく	"쓸다, 청소하다"	
吐く	はく	"토하다, 내뱉다"	
挟まる	はさまる	틈새에 끼이다	
挟む	はさむ	"끼우다, 사이에 두다"	
罰する	ばっする	"벌주다, 처벌하다"	
離す	はなす	"떼다, 거리를 두다"	
放す	はなす	"놓다, 풀어 놓다"	
放れる	はなれる	"놓이다, 풀리다"	
跳ねる	はねる	"뛰어 오르다, 튀다"	
はめる		"끼우다, 끼다, 채우다"	
早める	はやめる	"서두르다, 앞당기다"	
速める	はやめる	속도를 높이다	
流行る	はやる	"유행하다, 인기가 있다"	
はらむ		"임신하다, 품다, 내포하다"	
張る	はる	"뻗다, 부풀다, 붙이다, 바르다"	
ひねる		"돌리다, 꼬집다, 비틀다"	
響く	ひびく	(소리가) 울리다	
広げる	ひろげる	"펼치다, 넓히다"	
広める	ひろめる	"넓히다, 퍼뜨리다"	
殖える	ふえる	"늘다, 번식하다"	
深まる	ふかまる	깊어지다	
拭く	ふく	"닦다, 훔치다"	
膨らます	ふくらます	"부풀게 하다, 부풀리다"	
膨らむ	ふくらむ	"부풀어 오르다, 불룩해지다"	
更ける	ふける	"깊어지다, 이슥해지다"	
塞がる	ふさがる	"막히다, 차다"	
ふざける		"농하다, 까불다"	
防ぐ	ふせぐ	"막다, 방지하다"	
ぶつ		"때리다, 치다"	
殖やす	ふやす	(돈・재산을) 늘리다	
振る	ふる	흔들다	
震える	ふるえる	"흔들리다, 떨리다"	
凹む	へこむ	"움푹 패다, 꺼지다"	
減る	へる	"줄다, 닳다, (배가) 고프다"	
経る	へる	"지나다, 경유하다"	
ほうる		"집어 던지다, 내팽개치다"	
ほえる		(개・짐승 따위가) 짖다	
干す	ほす	말리다	
解く	ほどく	"풀다, 뜯다, 풀이하다"	
彫る	ほる	"(칼로) 새기다, 조각하다"	
任せる	まかせる	맡기다	
まく		"(씨를) 뿌리다, 파종하다"	
巻く	まく	"감다, 말다"	
混ざる・交ざる	まざる	섞이다	
混じる・交じる	まじる	섞이다	
交える	まじえる	"섞다, 합치다"	
混ぜる	まぜる	"넣어 섞다, 혼합하다"	
またぐ		"타 넘다, 건너다, 걸치다"	
祭る	まつる	"제사 지내다, 모시다"	
まとまる		"하나로 정리되다, 합쳐지다"	
まとめる		"하나로 정리하다, 합치다"	
丸める	まるめる	둥글게 하다	
回す	まわす	"돌리다, 회전시키다, 두르다"	
満たす	みたす	"채우다, 충족시키다"	
満ちる	みちる	가득 차다	
診る	みる	"보다, 진찰하다"	
向ける	むける	"향하다, 돌리다"	
蒸す	むす	"무덥다, 찌다"	
結ぶ	むすぶ	"묶다, 잇다, 관계를 맺다"	
命じる・命ずる	めいじる・めいずる	명하다	
恵む	めぐむ	"은혜를 베풀다, 인정을 베풀다"	
巡る	めぐる	"돌다, 순회하다, 둘러싸다"	
儲かる	もうかる	"벌이가 되다, 덕을 보다"	
儲ける	もうける	"벌다, 이익을 보다"	
燃える	もえる	(불)타다	
潜る	もぐる	"잠수하다, 숨어들다"	
もたれる		"기대다, 의지하다"	
用いる	もちいる	"사용하다, 채용하다"	
もむ		"비비다, 문지르다, 주무르다"	
燃やす	もやす	불태우다	
漏れる	もれる	"새다, 누설되다, 빠지다"	
盛る	もる	"쌓아 올리다, 담다"	
訳す	やくす	"번역하다, 해석하다"	
破く	やぶく	찢다	
破る	やぶる	"찢다, 깨다, (약속을) 어기다"	
ゆでる		"데치다, 삶다"	
許す	ゆるす	"허락하다, 용서하다"	
酔う	よう	"술에 취하다, 멀미하다"	
汚す	よごす	더럽히다	
止す	よす	"중지하다, 그만두다"	
寄せる	よせる	"밀려오다, 들르다, 가까이 하다"	
因る	よる	"기인하다, 원인이 되다"	
喜ばせる	よろこばせる	기쁘게 하다	
弱める	よわめる	약화시키다	
渡す	わたす	건네다	
割れる	われる	깨지다	
青白い	あおじろい	"파르스름하다, 창백하다"	
粗い	あらい	"성글다, 거칠다, 조잡하다"	
意地悪い	いじわるい	"심술궂다, 짓궂다"	
痛ましい	いたましい	"애처롭다, 가엾다"	
惜しい	おしい	"아깝다, 아쉽다"	
おそろしい		"두렵다, 무섭다"	
大人しい	おとなしい	"얌전하다, 점잖다"	
重苦しい	おもくるしい	"답답하다, 울적하다"	
重たい	おもたい	"무겁다, 묵직하다"	
硬い	かたい	"딱딱하다, 단단하다"	
堅い	かたい	"굳건하다, 견고하다, 확고하다"	
かゆい		가렵다	
清い	きよい	"맑다, 깨끗하다"	
くだらない		"하찮다, 시시하다"	
煙い	けむい	"(연기가) 맵다, 매캐하다"	
恋しい	こいしい	그립다	
騒がしい	さわがしい	"시끄럽다, 떠들썩하다"	
塩辛い	しおからい	짜다	
四角い	しかくい	"네모지다, 각지다"	
親しい	したしい	"친하다, 의좋다"	
ずうずうしい		뻔뻔스럽다	
すっぱい		"시다, 시큼하다"	
力強い	ちからづよい	"마음 든든하다, 힘차다"	
茶色い	ちゃいろい	갈색이다	
でかい		"크다, 방대하다"	
永い	ながい	"아주 오래다, 영원하다"	
憎らしい	にくらしい	"밉살스럽다, 얄밉다"	
眠たい	ねむたい	졸리다	
のろい		"느리다, 둔하다"	
ばからしい		"어리석다, 어이없다"	
甚だしい	はなはだしい	"아주 심하다, 대단하다"	
平たい	ひらたい	"평평하다, 넓적하다"	
真っ白い	まっしろい	새하얗다	
まぶしい		눈부시다	
みにくい		"추하다, 보기 흉하다"	
めでたい		"경사스럽다, 기쁘다"	
面倒臭い	めんどうくさい	"아주 귀찮다, 몹시 성가시다"	
申し訳ない	もうしわけない	변명의 여지가 없다	
もったいない		"아깝다, 과분하다"	
ものすごい		"굉장하다, 아주 무섭다"	
安っぽい	やすっぽい	"값싸다, 싸구려 같다"	
若々しい	わかわかしい	"어려 보이다, 생기발랄하다"	
当たり前な	あたりまえな	"당연한, 보통의"	
あやふやな		"불확실한, 애매한"	
新たな	あらたな	"새로운, 생생한"	
ありがちな		"흔한, 흔히 있는"	
意外な	いがいな	"뜻밖의, 의외의"	
円満な	えんまんな	원만한	
大柄な	おおがらな	"몸집이 큰, 모양이 큰"	
おおざっぱな		"대략적인, 조잡한"	
おしゃれな		"멋을 낸, 멋쟁이인"	
同じ	おなじ	"같은, 똑같은"	
温和な	おんわな	(날씨・성격이) 온화한	
快適な	かいてきな	쾌적한	
確実な	かくじつな	"확실한, 틀림없는"	
格別な	かくべつな	"각별한, 특별한"	
過激な	かげきな	과격한	
がらがらな		텅텅 비어 있는	
簡略な	かんりゃくな	간략한	
機敏な	きびんな	"기민한, 민첩한"	
逆	ぎゃく	"반대, 거꾸로"	
急激な	きゅうげきな	급격한	
急速な	きゅうそくな	아주 빠른	
強力な	きょうりょくな	강력한	
具体的な	ぐたいてきな	구체적인	
けちな		"인색한, 쩨쩨한"	
下品な	げひんな	품위가 없는	
謙虚な	けんきょな	겸허한	
懸命な	けんめいな	"열심인, 필사적인"	
高級な	こうきゅうな	고급스러운	
肯定的な	こうていてきな	긍정적인	
高等な	こうとうな	"고등, 수준이 높은"	
公平な	こうへいな	공평한	
困難な	こんなんな	곤란한	
逆さ・逆様	さかさ・さかさま	"거꾸로 됨, 반대로 됨"	
ささやかな		"자그마한, 사소한, 조촐한"	
さわやかな		"상쾌한, 시원한"	
しきりな		"빈번한, 계속되는"	
実用的な	じつようてきな	실용적인	
純粋な	じゅんすいな	순수한	
消極的な	しょうきょくてきな	소극적인	
詳細な	しょうさいな	상세한	
上等な	じょうとうな	"고급의, 훌륭한"	
新鮮な	しんせんな	"신선한, 새롭고 산뜻한"	
正確な	せいかくな	정확한	
正当な	せいとうな	정당한	
絶対的な	ぜったいてきな	절대적인	
絶好調な	ぜっこうちょうな	"아주 좋은, 더 없이 좋은"	
全国的な	ぜんこくてきな	전국적인	
鮮明な	せんめいな	선명한	
粗末な	そまつな	"허술한, 변변찮은"	
対等な	たいとうな	"대등한, 동등한"	
平らな	たいらな	"평평한, 평탄한"	
多難な	たなんな	다난한	
たまな		드문	
多様な	たような	다양한	
単調な	たんちょうな	단조로운	
知的な	ちてきな	지적인	
着実な	ちゃくじつな	착실한	
強気な	つよきな	"강경한, 적극적인"	
的確な・適確な	てきかくな	"적확한, 정확한"	
凸凹な	でこぼこな	"울퉁불퉁한, 불균형한"	
手ごろな	てごろな	"알맞은, 적당한"	
同一な	どういつな	"동일한, 같은"	
透明な	とうめいな	투명한	
特別な	とくべつな	특별한	
鈍感な	どんかんな	둔감한	
斜めな	ななめな	"경사진, 비스듬한"	
生意気な	なまいきな	"건방진, 주제 넘는"	
滑らかな	なめらかな	"매끄러운, 순조로운"	
軟弱な	なんじゃくな	"연약한, 무르고 약한"	
のんきな		"태평한, 느긋한"	
莫大な	ばくだいな	막대한	
皮肉な	ひにくな	"짓궂은, 얄궂은, 빈정거리는"	
不規則な	ふきそくな	불규칙한	
不潔な	ふけつな	"불결한, 더러운"	
無事な	ぶじな	"무사한, 평온한"	
不自由な	ふじゆうな	"자유롭지 못한, 불편한"	
不要な	ふような	불필요한	
不利な	ふりな	불리한	
不良な	ふりょうな	불량한	
平凡な	へいぼんな	평범한	
ぺこぺこ		배가 몹시 고픈	
膨大な	ぼうだいな	방대한	
ぼろぼろ		너덜너덜한	
本気な	ほんきな	"진심인, 진지한"	
みじめな		"비참한, 참혹한"	
無限な	むげんな	무한한	
無数な	むすうな	무수한	
無力な	むりょくな	무력한	
めちゃくちゃな		엉망진창인	
厄介な	やっかいな	"귀찮은, 성가신"	
勇敢な	ゆうかんな	용감한	
有能な	ゆうのうな	유능한	
悠々な	ゆうゆうな	"느긋한, 아득히 먼"	
緩やかな	ゆるやかな	"완만한, 느슨한, 느긋한"	
容易な	よういな	"용이한, 아주 쉬운"	
余計な	よけいな	"많은, 불필요한"	
弱気な	よわきな	"무기력한, 나약한"	
良好な	りょうこうな	양호한	
空き～	あき～	"속이 빔, 빈~"	空き缶[あきかん] 빈 깡통、空き部屋[あきべや] 빈 방
悪～	あく～	악~	悪循環[あくじゅんかん] 악순환、悪感情[あくかんじょう] 악감정、悪趣味[あくしゅみ] 악취미
あくる～		다음~	"あくる朝[あくるあさ] 이튿날 아침、あくる年[あくるとし] 이듬해, 다음 해、あくる日[あくるひ] 다음날, 이튿날"
ある～		"어떤~, 어느~"	ある人[あるひと] 어떤 사람、ある日[あるひ] 어떤 날、ある所[あるところ] 어느 곳
異～	い～	"이~, 다른~"	"異業種[いぎょうしゅ] 다른 업종、異民族[いみんぞく] 이민족、異国[いこく] 이국, 외국"
幾～	いく～	몇~	幾日[いくにち] 며칠、幾人[いくにん] 몇 명、幾千万[いくせんまん] 몇 천만
一～	いち～	"한~, 한 명의~, 일~"	"一音楽家[いちおんがくか] 한 음악가、一社会人[いちしゃかいじん] 한 사회인、一新聞記者[いちしんぶんきしゃ] 한 신문기자、一時[いちじ] 일시, 한 때、一種[いっしゅ] 일종、一案[いちあん] 일안, 하나의 제안"
薄～	うす～	"어쩐지~, 약간~"	薄汚い[うすぎたない] 지저분하다、薄ぼんやり[うすぼんやり] 희미함、薄気味悪い[うすきみわるい] 섬뜩하다
大～	おお～	"큰~, 많은~"	大急ぎ[おおいそぎ] 몹시 서두름、大騒ぎ[おおさわぎ] 큰 소동、大火事[おおかじ] 큰 화재
御～	おん～	[お]보다 존경・공손의 뜻이 강함	御礼[おんれい] 사례(의 말)、御身[おんみ] 옥체
各～	かく～	각~	各選手[かくせんしゅ] 각 선수、各家庭[かくかてい] 각 가정、各方面[かくほうめん] 각 방면
仮～	かり～	가~	仮契約[かりけいやく] 가계약、仮処分[かりしょぶん] 가처분、仮製本[かりせいほん] 가제본
逆～	ぎゃく～	역~	逆回転[ぎゃくかいてん] 역회전、逆効果[ぎゃくこうか] 역효과、逆差別[ぎゃくさべつ] 역차별
旧～	きゅう～	"구~, 옛~"	旧体制[きゅうたいせい] 구체제、旧植民地[きゅうしょくみんち] 옛 식민지、旧正月[きゅうしょうがつ] 음력설
急～	きゅう～	급~	急上昇[きゅうじょうしょう] 급상승、急カーブ[きゅうかーぶ] 급커브、急ブレーキ[きゅうぶれーき] 급제동
劇～	げき～	극~	劇作家[げきさっか] 극작가、劇映画[げきえいが] 극영화、劇台本[げきだいほん] 극 대본
現～	げん～	현~	現時点[げんじてん] 현 시점、現政府[げんせいふ] 현 정부、現住所[げんじゅうしょ] 현 주소
小～	こ～	"약간~, 다소~"	"小ぎれい[こぎれい] 말쑥함, 깔끔함、小汚い[こぎたない] 추레하다, 꾀죄죄하다"
高～	こう～	고~	高学歴[こうがくれき] 고학력、高気圧[こうきあつ] 고기압、高血圧[こうけつあつ] 고혈압
好～	こう～	호~	"好景気[こうけいき] 호경기, 호황、好都合[こうつごう] 형편・상황이 좋음、好条件[こうじょうけん] 좋은 조건"
今～	こん～	"금번~, 이번~"	"今大会[こんたいかい] 이번 대회、今シーズン[こんしーずん] 이번 시즌、今季[こんき] 지금 계절, 이번 시즌"
再～	さい～	재~	再発行[さいはっこう] 재발행、再検査[さいけんさ] 재검사、再評価[さいひょうか] 재평가
最～	さい～	"최~, 가장~"	"最高級[さいこうきゅう] 최고급、最後尾[さいこうび] 최후미, 맨 뒤、最新作[さいしんさく] 최신작"
昨～	さく～	지난~	作十五日[さくじゅうごにち] 지난 15일、昨シーズン[さくしーずん] 지난 시즌
試～	し～	시~	"試運転[しうんてん] 시운전, 시운행、試着[しちゃく] 시착, 입어봄、試飲[しいん] 시음"
主～	しゅ～	주~	主産地[しゅさんち] 주산지、主目的[しゅもくてき] 주목적、主電源[しゅでんげん] 주 전원
重～	じゅう～	중~	重労働[じゅうろうどう] 중노동、重工業[じゅうこうぎょう] 중공업、重金属[じゅうきんぞく] 중금속
純～	じゅん～	순~	純国産[じゅんこくさん] 순 국산、純収入[じゅんしゅうにゅう] 순수입、純文学[じゅんぶんがく] 순수 문학
準～	じゅん～	준~	準会員[じゅんかいいん] 준회원、準々決勝[じゅんじゅんけっしょう] 준준결승、準公務員[じゅんこうむいん] 준공무원
諸～	しょ～	"제~, 여러~"	諸条件[しょじょうけん] 여러 조건、諸事情[しょじじょう] 여러 사정、諸団体[しょだんたい] 여러 단체
初～	しょ～	"초~, 첫~"	"初対面[しょたいめん] 첫 대면, 첫 만남、初演[しょえん] 초연、初夏[しょか] 초여름"
助～	じょ～	조~	助教授[じょきょうじゅ] 조교수、助監督[じょかんとく] 조감독、助動詞[じょどうし] 조동사
小～	しょう～	소~	小資金[しょうしきん] 적은 자금、小都市[しょうとし] 소도시、小論文[しょうろんぶん] 소논문
上～	じょう～	좋은~	上成績[じょうせいせき] 좋은 성적、上きげん[じょうきげん] 매우 좋은 기분
新～	しん～	신~	新学期[しんがっき] 신학기、新商品[しんしょうひん] 신상품、新記録[しんきろく] 신기록
素～	す～	"맨~, 그저 ~함"	素通り[すどおり] 그대로 지나침 、素泊まり[すどまり] 잠만 자는 숙박、素顔[すがお] 맨 얼굴
前～	ぜん～	전~	前市長[ぜんしちょう] 전 시장、前近代的[ぜんきんだいてき] 전근대적、前年度[ぜんねんど] 전년도
全～	ぜん～	전~	全国民[ぜんこくみん] 전 국민、全学生[ぜんがくせい] 전체 학생、全八巻[ぜんはっかん] 전 8권
総～	そう～	총~	総選挙[そうせんきょ] 총선거、総収入[そうしゅうにゅう] 총수입、総決算[そうけっさん] 총결산
多～	た～	다~	多機能[たきのう] 다기능、多方面[たほうめん] 다방면、多目的[たもくてき] 다목적
対～	たい～	대~	対米輸出[たいべいゆしゅつ] 대미 수출、対欧州貿易[たいおうしゅうぼうえき] 대유럽 무역
大～	だい～	대~	大歓迎[だいかんげい] 대환영、大規模[だいきぼ] 대규모、大成功[だいせいこう] 대성공
短～	たん～	단~	短期間[たんきかん] 단기간、短距離[たんきょり] 단거리、短時間[たんじかん] 단시간
低～	てい～	저~	低姿勢[ていしせい] 저자세、低気圧[ていきあつ] 저기압、低成長[ていせいちょう] 저성장
同～	どう～	"동~, 같은~"	同時代[どうじだい] 동시대、同形式[どうけいしき] 같은 형식、同問題[どうもんだい] 같은 문제
生～	なま～	생~	生放送[なまほうそう] 생방송、生ビール[なまビール] 생맥주、生演奏[なまえんそう] 라이브 연주
反～	はん～	반~	反社会的[はんしゃかいてき] 반사회적、反政府[はんせいふ] 반정부、反体制[はんたいせい] 반체제
半～	はん～	반~	半永久的[はんえいきゅうてき] 반영구적、半そで[はんそで] 반소매、半自動[はんじどう] 반자동
非～	ひ～	비~	非常識[ひじょうしき] 몰상식함、非科学的[ひかがくてき] 비과학적、非公開[ひこうかい] 비공개
一～	ひと～	한~	一握り[ひとにぎり] 한 줌、一勝負[ひとしょうぶ] 한판 승부、一仕事[ひとしごと] 잠시 일함
不～	ふ～	"불~, 부~"	不規則[ふきそく] 불규칙함、不自由[ふじゆう] 불편함、不公平[ふこうへい] 불공평함
無～	ぶ～	"무~, ~하지 않음"	"無遠慮[ぶえんりょ] 사양하지 아니함、無愛想[ぶあいそう] 상냥치 못함、無作法[ぶさほう] 예의에 어긋남, 버릇없음"
副～	ふく～	부~	副委員長[ふくいいんちょう] 부위원장、副作用[ふくさよう] 부작용、副収入[ふくしゅうにゅう] 부수입
古～	ふる～	헌~	古本屋[ふるほんや] 헌책방、古新聞[ふるしんぶん] 헌 신문、古着[ふるぎ] 헌 옷
別～	べつ～	"별~, 다른~"	別問題[べつもんだい] 다른 문제、別世界[べっせかい] 별세계、別行動[べつこうどう] 다른 행동
本～	ほん～	"본~, 이~"	本製品[ほんせいひん] 본 제품、本建築[ほんけんちく] 본 건축、本事件[ほんじけん] 본 사건
真～	ま～	"참~, 진~, 바로~"	真正面[ましょうめん] 바로 정면、真上[まうえ] 바로 위、真っ赤[まっか] 새빨감
未～	み～	미~	未完成[みかんせい] 미완성、未公開[みこうかい] 미공개、未解決[みかいけつ] 미해결
明～	みょう～	다음~	明年[みょうねん] 내년、明朝[みょうちょう] 내일 아침、明春[みょうしゅん] 내년 봄
元～	もと～	전~	元首相[もとしゅしょう] 전 수상、元大統領[もとだいとうりょう] 전 대통령、元彼[もとかれ] 전 남자친구
要～	よう～	"요~, ~이 필요함"	要観察[ようかんさつ] 관찰이 필요함、要検討[ようけんとう] 검토가 필요함、要注意[ようちゅうい] 요주의
来～	らい～	다음~	来夏[らいか] 내년 여름、来年度[らいねんど] 내년도
両～	りょう～	"양~, 두~"	"両手[りょうて] 양손、両陣営[りょうじんえい] 양 진영, 두 진영、両極端[りょうきょくたん] 양극단"
和～	わ～	일본(식)의~	和菓子[わがし] 일본식 과자、和食[わしょく] 일식、和服[わふく] 일본 옷
我が～	わが～	우리~	我が校[わがこう] 우리 학교、我が社[わがしゃ] 우리 회사、我が家[わがや] 우리 집
～愛	～あい	~애	人類愛[じんるいあい] 인류애、同性愛[どうせいあい] 동성애、母性愛[ぼせいあい] 모성애
～明け	～あけ	~이 끝난 직후	休み明け[やすみあけ] 휴가 직후、梅雨明け[つゆあけ] 장마가 끝난 직후
～あたり		"~쯤, ~경"	来月あたり[らいげつあたり] 다음 달쯤、去年あたり[きょねんあたり] 작년쯤
～案	～あん	~안	改革案[かいかくあん] 개혁안、妥協案[だきょうあん] 타협안、予算案[よさんあん] 예산안
～一色	～いっしょく	~일색	反対派一色[はんたいはいっしょく] 반대파 일색、ワールドカップ一色[ワールドカップいっしょく] 월드컵 일색
～一	～いち	"~최고, ~제일"	日本一[にほんいち] 일본 제일、世界一[せかいいち] 세계 최고、全国一[ぜんこくいち] 전국 최고
～液	～えき	~액	消化液[しょうかえき] 소화액、水溶液[すいようえき] 수용액、不凍液[ふとうえき] 부동액
～園	～えん	~원	動物園[どうぶつえん] 동물원、植物園[しょくぶつえん] 식물원、幼稚園[ようちえん] 유치원
～おきに		"~걸러, ~간격으로"	一人おきに[ひとりおきに] 한 사람 걸러、一週間おきに[いっしゅうかんおきに] 일주일 간격으로、二メートルおきに 2미터 간격으로
～価	～か	~가	栄養価[えいようか] 영양가、販売価[はんばいか] 판매가、真価[しんか] 진가
～下	～か	~하	監督下[かんとくか] 감독하、支配下[しはいか] 지배하、管轄下[かんかつか] 관할하
～画	～が	~화	西洋画[せいようが] 서양화、東洋画[とうようが] 동양화、水彩画[すいさいが] 수채화
～界	～かい	~계	映画界[えいがかい] 영화계、芸能界[げいのうかい] 예능계、教育界[きょういくかい] 교육계
～街	～がい	~가	繫華街[はんかがい] 번화가、官庁街[かんちょうがい] 관청가、暗黒街[あんこくがい] 암흑가
～外	～がい	"~외, ~밖"	問題外[もんだいがい] 문제 밖、領域外[りょういきがい] 영역 외、予定外[よていがい] 예정 밖
～係	～がかり	"~계, ~담당"	会計係[かいけいがかり] 회계 담당、出納係[すいとうがかり] 출납계、接待係[せったいがかり] 접대 담당
～額	～がく	~액	限度額[げんどがく] 한도액、目標額[もくひょうがく] 목표액、差額[さがく] 차액
～掛け	～かけ	~하다 맒	やり掛け[やりかけ] 하다 맒、読み掛け[よみかけ] 읽다 맒、書き掛け[かきかけ] 쓰다 맒
～型	～がた	~형	最新型[さいしんがた] 최신형、努力型[どりょくがた] 노력형、天才型[てんさいがた] 천재형
～刊	～かん	~간(행)	2015年刊[ねんかん] 2015년 간(행)、近刊[きんかん] 근간
～観	～かん	~관	価値観[かちかん] 가치관、人生観[じんせいかん] 인생관、歴史観[れきしかん] 역사관
～器	～き	~기(도구)	"受話器[じゅわき] 수화기、呼吸器[こきゅうき] 호흡기、洗面器[せんめんき] 세면기, 세면대"
～機	～き	~기(기계)	写真機[しゃしんき] 사진기、発電機[はつでんき] 발전기、探知機[たんちき] 탐지기
～もっての		~제일의	クラスもっての 반에서 제일 가는、野球界もっての[やきゅうかいもっての] 야구계에서 제일 가는
～気味	～ぎみ	"~기미, ~기색"	上がり気味[あがりぎみ] 오를 기미、焦り気味[あせりぎみ] 초조해하는 기색
～強	～きょう	~정도	五百円強[ごひゃくえんきょう] 500엔 정도、三キロ強[さんきろきょう] 3킬로그램 정도
～教	～きょう	~교	キリスト教[きりすときょう] 기독교、仏教[ぶっきょう] 불교、イスラム教[いすらむきょう] 이슬람교
～業	～ぎょう	~업	製造業[せいぞうぎょう] 제조업、建築業[けんちくぎょう] 건축업、販売業[はんばいぎょう] 판매업
～切り	～ぎり	다 ~함	在庫切り[ざいこぎり] 재고 없음、時間切り[じかんぎり] 시간이 다 됨
～際	～ぎわ	~하려고 할 때	散り際[ちりぎわ] 지는 때、入り際[はいりぎわ] 들어가려고 할 때
～句	～く	~구	慣用句[かんようく] 관용구、挿入句[そうにゅうく] 삽입구、定型句[ていけいく] 정형구
～口	～ぐち	~구	改札口[かいさつぐち] 개찰구、非常口[ひじょうぐち] 비상구、通用口[つうようぐち] 통용 출입구
～軍	～ぐん	~군	革命軍[かくめいぐん] 혁명군、政府軍[せいふぐん] 정부군、反乱軍[はんらんぐん] 반란군
～家	～け	"~가, ~의 집안"	"将軍家[しょうぐんけ] 장군의 집안、山本家[やまもとけ] 야마모토의 집안、武家[ぶけ] 무가, 무사 집안"
～系	～けい	~계	"銀河系[ぎんがけい] 은하계、太陽系[たいようけい] 태양계、外資系[がいしけい] 외자계, 외국계"
～劇	～げき	~극	時代劇[じだいげき] 시대극、創作劇[そうさくげき] 창작극、人形劇[にんぎょうげき] 인형극
～権	～けん	~권	所有権[しょゆうけん] 소유권、指導権[しどうけん] 지도권、経営権[けいえいけん] 경영권
～庫	～こ	"~고, ~창고"	貯蔵庫[ちょぞうこ] 저장고、車庫[しゃこ] 차고、冷凍庫[れいとうこ] 냉동고
～後	～ご	~후	放課後[ほうかご] 방과 후、事後[じご] 사후、食後[しょくご] 식후
～工	～こう	~공	機械工[きかいこう] 기계공、修理工[しゅうりこう] 수리공、画工[がこう] 화공
～港	～こう	~항	貿易港[ぼうえきこう] 무역항、自由港[じゆうこう] 자유항、輸出港[ゆしゅつこう] 수출항
～号	～ごう	~호	第一号[だいいちごう] 제1호、創刊号[そうかんごう] 창간호、一月号[いちがつごう] 1월호
～国	～こく	~국	先進国[せんしんこく] 선진국、共和国[きょうわこく] 공화국、強大国[きょうだいこく] 강대국
～ごと		"~째, ~마다"	"まるごと 통째로、皮ごと[かわごと] 껍질 째、車ごと[くるまごと] 자동차 그대로
5分ごとに[ごふんごとに] 5분마다、会う人ごとに[あうひとごとに] 만나는 사람마다"
～小屋	～ごや	~간	"物置小屋[ものおきごや] 헛간、山小屋[やまごや] 산막, 산장、馬小屋[うまごや] 마구간"
～差	～さ	~차	温度差[おんどさ] 온도 차、時間差[じかんさ] 시간 차、個人差[こじんさ] 개인차
～祭	～さい	"~제, ~축제"	学園祭[がくえんさい] 학교 축제、映画祭[えいがさい] 영화제、文化祭[ぶんかさい] 문화제
～財	～ざい	~재	消費財[しょうひざい] 소비재、代替財[だいたいざい] 대체재、文化財[ぶんかざい] 문화재
～剤	～ざい	"~제, ~약"	消毒剤[しょうどくざい] 소독제、睡眠剤[すいみんざい] 수면제、洗浄剤[せんじょうざい] 세정제
～罪	～ざい	~죄	傷害罪[しょうがいざい] 상해죄、詐欺罪[さぎざい] 사기죄、脅迫罪[きょうはくざい] 협박죄
～作	～さく	~작	代表作[だいひょうさく] 대표작、最新作[さいしんさく] 최신작、デビュー作[デビューさく] 데뷔작
～史	～し	~사	世界史[せかいし] 세계사、文学史[ぶんがくし] 문학사、古代史[こだいし] 고대사
～士	～し	~사	飛行士[ひこうし] 비행사、弁護士[べんごし] 변호사、機関士[きかんし] 기관사
～師	～し	~사	看護師[かんごし] 간호사、薬剤師[やくざいし] 약제사、詐欺師[さぎし] 사기꾼
～視	～し	~시	確実視[かくじつし] 확실시、重要視[じゅうようし] 중요시、問題視[もんだいし] 문제시
～誌	～し	~지	会報誌[かいほうし] 회보지、月刊誌[げっかんし] 월간지、週刊誌[しゅうかんし] 주간지
～式	～しき	~식	"卒業式[そつぎょうしき] 졸업식、結婚式[けっこんしき] 결혼식、成人式[せいじんしき] 성인식、
最新式[さいしんしき] 최신식、充電式[じゅうでんしき] 충전식、旧式[きゅうしき] 구식"
～次第	～しだい	~하는 대로	決まり次第[きまりしだい] 결정되는 대로、到着次第[とうちゃくしだい] 도착하는 대로
～室	～しつ	~실	研究室[けんきゅうしつ] 연구실、実験室[じっけんしつ] 실험실、面会室[めんかいしつ] 면회실
～弱	～じゃく	"약~, ~이 조금 안됨"	十万円弱[じゅうまんえんじゃく] 약 10만 엔、三千名弱[さんぜんめいじゃく] 약 3천 명
～手	～しゅ	~수(직업)	運転手[うんてんしゅ] 운전수、歌手[かしゅ] 가수、外野手[がいやしゅ] 외야수
～酒	～しゅ	~주	日本酒[にほんしゅ] 일본주、果実酒[かじつしゅ] 과실주、洋酒[ようしゅ] 양주
～集	～しゅう	~집	問題集[もんだいしゅう] 문제집、用例集[ようれいしゅう] 용례집、写真集[しゃしんしゅう] 사진집
～術	～じゅつ	~술	航海術[こうかいじゅつ] 항해술、催眠術[さいみんじゅつ] 최면술、占星術[せいせいじゅつ] 점성술
～順	～じゅん	~순	番号順[ばんごうじゅん] 번호순、年度順[ねんどじゅん] 연도순、先着順[せんちゃくじゅん] 선착순
～所	～しょ・～じょ	~소	"市役所[しやくしょ] 시청、研究所[けんきゅうじょ] 연구소、停留所[ていりゅうじょ] 정류소, 정류장"
～賞	～しょう	~상	新人賞[しんじんしょう] 신인상、努力賞[どりょくしょう] 노력상、優秀賞[ゆうしゅうしょう] 우수상
～商	～しょう	~상	雑貨商[ざっかしょう] 잡화상、小売商[しょうばいしょう] 소매상、貿易商[ぼうえきしょう] 무역상
～省	～しょう	~성	外務省[がいむしょう] 외무성(외교부)、厚生省[こうせいしょう] 후생성(보건복지부)、文部省[もんぶしょう] 문부성(교육부)
～症	～しょう	~증	"合併症[がっぺいしょう] 합병증、過敏症[かびんしょう] 과민증、花粉症[かふんしょう] 화분증, 꽃가루 알레르기"
～証	～しょう	~증	学生証[がくせいしょう] 학생증、免許証[めんきょしょう] 면허증、登録証[とうろくしょう] 등록증
～上	～じょう	~상	歴史上[れきしじょう] 역사상、法律上[ほうりつじょう] 법률상、見かけ上[みかけじょう] 외관상
～状	～じょう	"~장; ~형태, ~상태"	"案内状[あんないじょう] 안내장、告訴状[こくそじょう] 고소장、催促状[さいそくじょう] 독촉장
球状[きゅうじょう] 구형, 둥근 형태、液状[えきじょう] 액상, 액체 상태"
～場	～じょう	~장	競技場[きょうぎじょう] 경기장、運動場[うんどうじょう] 운동장、駐輪場[ちゅうりんじょう] 자전거 주차장
～色	～しょく	~색	保護色[ほごしょく] 보호색、地方色[ちほうしょく] 지방색、郷土色[きょうどしょく] 향토색
～職	～しょく	~직	管理職[かんりしょく] 관리직、事務職[じむしょく] 사무직、専門職[せんもんしょく] 전문직
～数	～すう	~수	周波数[しゅうはすう] 주파수、得票数[とくひょうすう] 득표수、学生数[がくせいすう] 학생수
～済み	～ずみ	"~이 끝남, ~완료"	解決済み[かいけつずみ] 해결 완료、予約済み[よやくずみ] 예약 완료、消毒済み[しょうどくずみ] 소독 완료
～生	～せい	~생	留学生[りゅうがくせい] 유학생、研究生[けんきゅうせい] 연구생、新入生[しんにゅうせい] 신입생
～制	～せい	~제	罰金制[ばっきんせい] 벌금제、共和制[きょうわせい] 공화제、四年制[よせんせい] 4년제
～性	～せい	~성	安全性[あんぜんせい] 안전성、一貫性[いっかんせい] 일관성、遺伝性[いでんせい] 유전성
～席	～せき	~석	禁煙席[きんせんせき] 금연석、指定席[していせき] 지정석、助手席[じょしゅせき] 조수석
～線	～せん	~선	延長線[えんちょうせん] 연장선、国際線[こくさいせん] 국제선、電話線[でんわせん] 전화선
～船	～せん	~선	貨物船[かもつせん] 화물선、輸送船[ゆそうせん] 수송선、宇宙船[うちゅうせん] 우주선
～戦	～せん	~전	延長戦[せんちょうせん] 연장전、決勝戦[けっしょうせん] 결승전、空中戦[くうちゅうせん] 공중전
～全体	～ぜんたい	~전체	都内全体[とないぜんたい] 도내 전체、屋根全体[やねぜんたい] 지붕 전체
～全般	～ぜんぱん	~전반	経済全般[けいざいぜんぱん] 경제 전반、計画全般[けいかくぜんぱん] 계획 전반
～沿い	～ぞい	"~가, ~기슭"	"川沿い[かわぞい] 강가、山沿い[やまぞい] 산기슭、海岸沿い[かいがんぞい] 해안가, 바닷가"
～層	～そう	~층	知識層[ちしきそう] 지식층、読者層[どくしゃそう] 독자층、年齢層[ねんれいそう] 연령층
～育ち	～そだち	~에서 자람	温室育ち[おんしつそだち] 온실에서 자람、お嬢様育ち[おじょうさまそだち] 외동딸로 자람、東京育ち[とうきょうそだち] 도쿄에서 자람
～団	～だん	~단	青年団[せいねんだん] 청년단、調査団[ちょうさだん] 조사단、選手団[せんしゅだん] 선수단
～着	～ちゃく	"~도착, ~벌"	"5時着[ごじちゃく] 5시 도착、一着[いっちゃく] 일등, 한 벌"
～調	～ちょう	~조	"七五調[しちごちょう] 칠오조、復古調[ふっこちょう] 복고조、絶好調[ぜっこうちょう] 절호조, 최고 상태, 아주 좋음"
～庁	～ちょう	~청	検察庁[けんさつちょう] 검찰청、水産庁[すいさんちょう] 수산청、国税庁[こくぜいちょう] 국세청
～賃	～ちん	"~요금, ~삯"	航空賃[こうくうちん] 항공 요금、船賃[ふなちん] 뱃삯、手間賃[てまちん] 품삯
～づかい		~씀	"無駄づかい[むだづかい] 헛되이 씀、仮名づかい[かなづかい] かな 사용법、言葉づかい[ことばづかい] 말씨, 말투"
～付き	～つき	"~이 딸림, ~부"	景品付き[けいひんつき] 경품이 딸림、条件付きの賛成[じょうけんつきのさんせい] 조건부 찬성
～漬け	～づけ	"~에 빠짐, ~에 몰두"	英語漬け[えいごづけ] 영어 공부에 몰두、薬漬け[くすりづけ] 약물에 빠짐、ゴルフ漬け[ゴルフづけ] 골프에 빠짐
～づらい		~하기 어렵다	読みづらい[よみづらい] 읽기 어렵다、言いづらい[いいづらい] 말하기 어렵다
～手	～て	~하는 사람	"書き手[かきて] 쓰는 사람, 필자、語り手[かたりて] 말하는 사람, 화자、聞き手[ききて] 듣는 사람, 청자"
～点	～てん	~점	問題点[もんだいてん] 문제점、共通点[きょうつうてん] 공통점、妥協点[だきょうてん] 타협점
～展	～てん	~전	作品展[さくひんてん] 작품전、写真展[しゃしんてん] 사진전、企画展[きかくてん] 기획전
～度	～ど	~도	危険度[きけんど] 위험도、知名度[ちめいど] 지명도、理解度[りかいど] 이해도
～同士	～どうし	~끼리	近所同士[きんじょどうし] 이웃끼리、隣同士[となりどうし] 이웃끼리、いとこ同士[いとこどうし] 사촌끼리
～内	～ない	"~내, ~안"	期間内[きかんない] 기간내、時間内[じかんない] 시간내、教室内[きょうしつない] 교실 안
～難	～なん	~난	経営難[けいえいかん] 경영난、資金難[しきんなん] 자금난、生活難[せいかつなん] 생활난
～熱	～ねつ	~열	教育熱[きょういくねつ] 교육열、太陽熱[たいようねつ] 태양열、野球熱[やきゅうねつ] 야구열
～敗	～はい	"~패, ~패배"	三勝二敗[さんしょうにはい] 3승2패、連敗[れんぱい] 연패、惜敗[せきはい] 석패
～発	～はつ	"~발, ~출발"	ロンドン発[ロンドンはつ] 런던발、9時発[くじはつ] 9시 출발
～離れ	～ばなれ	~를 기피함	活字離れ[かつじばなれ] 활자를 멀리함、理科離れ[りかばなれ] 이과를 기피함
～犯	～はん	~범	現行犯[げんこうはん] 현행범、殺人犯[さつじんはん] 살인범、知能犯[ちのうはん] 지능범
～版	～ばん	~판	限定版[げんていばん] 한정판、改訂版[かいていばん] 개정판、最新版[さいしんばん] 최신판
～板	～ばん	~판	掲示板[けいじばん] 게시판、広告版[こうこくばん] 광고판、番号版[ばんごうばん] 번호판
～判	～ばん	~판	規格判[きかくばん] 규격판、名刺判[めいしばん] 명함판、A4判[エーよんばん] A4판
～費	～ひ	~비	研究費[けんきゅうひ] 연구비、生活費[せいかつひ] 생활비、交通費[こうつうひ] 교통비
～評	～ひょう	~평	審査評[しんさひょう] 심사평、人物評[じゅんぶつひょう] 인물평、好評[こうひょう] 호평
～表	～ひょう	~표	価格表[かかくひょう] 가격표、時刻表[じこくひょう] 시각표、予定表[よていひょう] 예정표
～病	～びょう	~병	皮膚病[ひふびょう] 피부병、成人病[せいじんびょう] 성인병、職業病[しょくぎょうびょう] 직업병
～風	～ふう	~풍	ヨーロッパ風[ヨーロッパふう] 유럽풍、洋風[ようふう] 서양풍、90年代風[きゅうじゅうねんだいふう] 90년대풍
～深い	～ぶかい	"~깊다, 아주 ~하다"	興味深い[きょうみぶかい] 흥미롭다、注意深い[ちゅういぶかい] 주의 깊다
～服	～ふく	~복	宇宙服[うちゅうふく] 우주복、作業服[さぎょうふく] 작업복、体操服[たいそうふく] 체육복
～物	～ぶつ	~물	飲食物[いんしょくぶつ] 음식물、刊行物[かんこうぶつ] 간행물、遺失物[いしつぶつ] 유실물
～ぶり		~만임	3年ぶり[さんねんぶり] 3년만임、しばらくぶり 오랜만임
～別	～べつ	~별	能力別[のうりょくべつ] 능력별、地方別[ちほうべつ] 지방별、職業別[しょくぎょうべつ] 직업별
～片	～へん	"~조각, ~토막"	金属片[きんぞくへん] 금속편、一片[いっぺん] 한 조각
～歩	～ほ	"~보, ~걸음"	"一歩[いっぽ] 일보, 한 걸음、二歩[にほ] 두 발짝、第一歩[だいいっぽ] 첫걸음"
～法	～ほう	~법	国際法[こくさいほう] 국제법、料理法[りょうりほう] 요리법、解決法[かいけつほう] 해결법
～報	～ほう	~보	社内報[しゃないほう] 사내보、注意報[ちゅういほう] 주의보、警報[けいほう] 경보
～末	～まつ	~말	学期末[がっきまつ] 학기말、今月末[こんげつまつ] 이달 말、世紀末[せいきまつ] 세기말
～味	～み	"~미, ~성"	現実味[げんじつみ] 현실성、人間味[にんげんみ] 인간미、真実味[しんじつみ] 진실성
～面	～めん	"~면, ~측면"	興行面[こうぎょうめん] 흥행면、金銭面[きんせんめん] 금전적인 면、構成面[こうせいめん] 구성 면
～元	～もと	~원	製造元[せいぞうもと] 제조원、販売元[はんばいもと] 판매원
～役	～やく	"~역, ~역할"	相談役[そうだんやく] 상담 역할、相手役[あいてやく] 상대역、司会役[しかいやく] 사회자 역할
～ら		~들	彼ら[かれら] 그들、それら 그것들、我ら[われら] 우리들
～来	～らい	~전부터	10年来[じゅうねんらい] 10년 전부터、年来[ねんらい] 몇 해 전부터、従来[じゅうらい] 지금까지
～裏	～り	~리	成功裏[せいこうり] 성공리、暗々裏[あんあんり] 암암리、秘密裏[ひみつり] 비밀리
～率	～りつ	~률/율	出生率[しゅっせいりつ] 출생률、致命率[ちめいりつ] 치사율、百分率[ひゃくぶんりつ] 백분율
～流	～りゅう	"~류, ~식"	自己流[じこりゅう] 자기식、西洋流[せいようりゅう] 서양식
～量	～りょう	~량	交通量[こうつうりょう] 교통량、食事量[しょくじりょう] 식사량、音量[おんりょう] 음량
～領	～りょう	"~령, ~영토"	フランス領[フランスりょう] 프랑스령、オランダ領[オランダりょう] 네덜란드령
～力	～りょく	~력	経済力[けいざいりょく] 경제력、理解力[りかいりょく] 이해력、思考力[しこうりょく] 사고력
～類	～るい	~류	文房具類[ぶんぼうぐるい] 문방구류、シーツ類[シーツるい] 시트류、魚介類[ぎょかいるい] 어패류
～歴	～れき	"~력, ~경력, ~이력"	受賞歴[じゅしょうれき] 수상 이력、指導歴[しどうれき] 지도 경력、選手歴[せんしゅれき] 선수 경력
～路	～ろ	~로	滑走路[かっそうろ] 활주로、通学路[つうがくろ] 통학로、輸送路[ゆそうろ] 수송로
～録	～ろく	"~록, ~기록"	会議録[かいぎろく] 회의록、回想録[かいそうろく] 회상록、見聞録[けんぶんろく] 견문록
～論	～ろん	~론	平和論[へいわろん] 평화론、歴史論[れきしろん] 역사론、理想論[りそうろん] 이상론
相打つ	あいうつ	"서로 치다, 서로 싸우다"	
仰向く	あおむく	위를 보다	
当てはめる	あてはめる	"맞추다, 적용시키다"	
歩き回る	あるきまわる	"걸어다니다, 돌아다니다"	
言い換える	いいかえる	바꿔 말하다	
言い付ける	いいつける	"명령하다, 고자질하다"	
威張る	いばる	"뽐내다, 거만하게 굴다"	
入れ換える	いれかえる	바꿔 넣다	
受け付ける	うけつける	"접수하다, 받아들이다"	
受け取る	うけとる	"수취하다, 받다"	
受け持つ	うけもつ	"맡다, 담당하다"	
移り住む	うつりすむ	"옮겨 살다, 이주하다"	
裏返す	うらかえす	뒤집다	
裏切る	うらぎる	"배반하다, 배신하다"	
売り出す	うりだす	"판매하다, 출시하다"	
上回る	うわまわる	"상회하다, 웃돌다"	
追い返す	おいかえす	"돌려보내다, 쫓아내다"	
追い掛ける	おいかける	뒤쫓아가다	
追い越す	おいこす	앞지르다	
追い込む	おいこむ	몰아넣다	
追い出す	おいだす	"내쫓다, 몰아내다"	
思い込む	おもいこむ	"굳게 결심하다, 믿다"	
折り返す	おりかえす	"되돌아가다, 되돌아오다"	
買い込む	かいこむ	사들이다	
書き換える	かきかえる	고쳐 쓰다	
書き込む	かきこむ	"적어넣다, 기입하다"	
書き取る	かきとる	"받아쓰다, 베껴 쓰다"	
書き直す	かきなおす	"다시 쓰다, 고쳐 쓰다"	
考え付く	かんがえつく	생각나다	
聞き返す	ききかえす	"되묻다, 다시 듣다"	
聞き取る	ききとる	알아듣다	
聞き直す	ききなおす	"되묻다, 다시 듣다"	
聞き流す	ききながす	건성으로 듣다	
気付く	きづく	"깨닫다, 알아차리다"	
くっつく		들러붙다	
くっつける		붙이다	
組み立てる	くみたてる	조립하다	
心得る	こころえる	"알다, 납득하다"	
言付ける	ことづける	"전언하다, 말을 전하다"	
さかのぼる		거슬러 올라가다	
差し引く	さしひく	"빼다, 제하다"	
下回る	したまわる	"하회하다, 밑돌다"	
絞り込む	しぼりこむ	좁혀나가다	
信じ込む	しんじこむ	믿어 의심치 않다	
吸い取る	すいとる	"흡수하다, 빨아들이다"	
透き通る	すきとおる	"비쳐 보이다, 투명하다"	
すれ違う	すれちがう	"스쳐 지나가다, 엇갈리다"	
背負う	せおう	"짊어지다, 업다"	
立ち上がる	たちあがる	"일어서다, 일어나다"	
立ち去る	たちさる	"떠나다, 물러나다"	
立ち止まる	たちどまる	멈추어 서다	
近寄る	ちかよる	"접근하다, 다가가다"	
使い切る	つかいきる	다 써버리다	
突き当たる	つきあたる	"부딪치다, 충돌하다"	
突っ込む	つっこむ	"깊이 파고들다, 처넣다"	
釣り合う	つりあう	"균형 잡히다, 어울리다"	
出迎える	でむかえる	마중 나가다	
問い返す	といかえす	"다시 묻다, 반문하다"	
問いかける	といかける	"묻다, 질문하다"	
通り掛かる	とおりかかる	마침 지나가다	
通り過ぎる	とおりすぎる	"지나치다, 통과하다"	
溶け込む	とけこむ	녹아 섞이다	
怒鳴る	どなる	"고함치다, 야단치다"	
飛び上がる	とびあがる	"날아오르다, 날뛰다"	
飛び降りる	とびおりる	뛰어내리다	
飛び越える	とびこえる	"뛰어넘다, 건너뛰다"	
飛び込む	とびこむ	"뛰어들다, 투신하다"	
飛び出す	とびだす	"뛰어나가다, 튀어나오다"	
飛び立つ	とびたつ	"날아가다, 날아오르다"	
飛び付く	とびつく	"달려들다, 덤벼들다"	
飛び乗る	とびのる	뛰어 올라타다	
飛び回る	とびまわる	날아다니다	
取り合う	とりあう	"맞잡다, 쟁탈하다"	
取り上げる	とりあげる	"집어 들다, 빼앗다"	
取り扱う	とりあつかう	"취급하다, 처리하다"	
取り集める	とりあつめる	한데 모으다	
取り入れる	とりいれる	"거둬들이다, 받아들이다"	
取り置く	とりおく	"남겨두다, 보관하다"	
執り行う	とりおこなう	"지내다, 거행하다"	
取り返す	とりかえす	"되찾다, 만회하다"	
取り替える	とりかえる	"바꾸다, 교환하다"	
取り囲む	とりかこむ	"둘러싸다, 에워싸다"	
取り交わす	とりかわす	교환하다	
取り決める	とりきめる	"결정하다, 계약하다"	
取り切る	とりきる	"모조리 따다, 전부 뜯다"	
取り組む	とりくむ	"맞붙다, 몰두하다"	
取り消す	とりけす	취소하다	
取り込む	とりこむ	"혼잡하다, 거둬들이다"	
取り出す	とりだす	"꺼내다, 골라 내다"	
取り直す	とりなおす	"다시 하다, 새로이 하다"	
取り戻す	とりもどす	"되찾다, 회복하다"	
取り止める	とりやめる	"그만두다, 중지하다"	
取り分ける	とりわける	"나누다, 갈라놓다"	
長引く	ながびく	"오래 끌다, 질질 끌다"	
乗り換える	のりかえる	"갈아타다, 바꿔 타다"	
乗り越える	のりこえる	극복하다	
走り回る	はしりまわる	"뛰어다니다, 동분서주하다"	
払い戻す	はらいもどす	남은 돈을 돌려주다	
張り切る	はりきる	"팽팽하다, 힘을 내다"	
引き受ける	ひきうける	"떠맡다, 인수하다"	
引き込む	ひきこむ	끌어들이다	
引き出す	ひきだす	"꺼내다, 끄집어내다"	
引き抜く	ひきぬく	"뽑다, 선발하다"	
引っ掛かる	ひっかかる	"걸리다, 걸려들다"	
引っ掛ける	ひっかける	걸다	
引っ繰り返す	ひっくりかえす	"뒤집다, 뒤엎다"	
引っ繰り返る	ひっくりかえる	"뒤집히다, 역전되다"	
ぶら下がる	ぶらさがる	"매달리다, 늘어지다"	
ぶら下げる	ぶらさげる	"매달다, 늘어뜨리다"	
振る舞う	ふるまう	행동하다	
微笑む	ほほえむ	미소 짓다	
真似る	まねる	"흉내내다, 모방하다"	
見上げる	みあげる	"올려다보다, 쳐다보다"	
見当たる	みあたる	"발견되다, 눈에 띄다"	
見合わせる	みあわせる	"마주 보다, 대조하다"	
見いだす	みいだす	"찾아내다, 발견하다"	
見失う	みうしなう	(시야에서) 놓치다	
見送る	みおくる	"배웅하다, 바래다주다"	
見落とす	みおとす	"간과하다, 못 보고 놓치다"	
見下ろす	みおろす	"내려다보다, 얕보다"	
見返す	みかえす	"다시 보다, 뒤돌아보다"	
見かける	みかける	"눈에 띄다, 가끔 보다"	
見込む	みこむ	"기대하다, 예상하다"	
見下げる	みさげる	"얕보다, 업신여기다"	
見詰める	みつめる	"응시하다, 주시하다"	
見直す	みなおす	"다시 보다, 재검토하다"	
見慣れる	みなれる	"눈에 익다, 낯익다"	
見舞う	みまう	병문안하다	
見分ける	みわける	"분별하다, 분간하다"	
目立つ	めだつ	"눈에 띄다, 두드러지다"	
持ち上げる	もちあげる	"들어 올리다, 쳐들다"	
基づく	もとづく	"기인하다, 바탕으로 하다"	
物語る	ものがたる	"말하다, 이야기를 하다"	
盛り上がる	もりあがる	"불거지다, 고조되다"	
役立つ	やくだつ	"도움이 되다, 쓸모가 있다"	
役立てる	やくだてる	유용하게 쓰다	
やっつける		해치우다	
やり直す	やりなおす	다시 하다	
指差す	ゆびさす	"손가락질하다, 가리키다"	
横切る	よこぎる	"가로지르다, 횡단하다"	
寄越す	よこす	"보내오다, 넘겨주다"	
呼びかける	よびかける	"부르다, 호소하다"	
呼び出す	よびだす	"호출하다, 불러내다"	
読み上げる	よみあげる	소리 내어 읽다	
読み切る	よみきる	끝까지 다 읽다	
読み通す	よみとおす	끝까지 다 읽다	
読み取る	よみとる	읽고 이해하다	
あくまで		"어디까지나, 끝까지"	
いずれ		"결국, 어쨌든, 조만간"	
いずれにせよ		어느 쪽이든	
今にも	いまにも	"당장에라도, 조금 있으면"	
至るところ	いたるところ	"도처에, 가는 곳마다"	
いちいち		"일일이, 하나하나"	
一段と	いちだんと	"한층, 더욱, 훨씬"	
いつでも		언제라도	
～一方	～いっぽう	"~하기만 함, ~하는 한편"	
いつまでも		"언제까지나, 영원히"	
いよいよ		"마침내, 드디어"	
うっかり		"깜빡, 무심코"	
うっすら		"어렴풋이, 희미하게"	
うろうろ		"우왕좌왕, 허둥지둥"	
うんと		"매우, 썩, 많이"	
得てして	えてして	"자칫, 자칫하면"	
大いに	おおいに	"대단히, 크게, 매우"	
おおむね		"대개, 대강, 대체로"	
おおよそ		"대강, 대략, 대체로"	
お気の毒に	おきのどくに	불쌍하게도	
お先に	おさきに	먼저	
遅くても	おそくても	늦어도	
思わず	おもわず	"엉겁결에, 나도 모르게"	
折り返し	おりかえし	"받은 즉시, 곧바로"	
かえって		"도리어, 오히려, 반대로"	
がらがら		"와르르, 드르륵"	
仮に	かりに	"만일, 만약, 임시로"	
仮にも	かりにも	"적어도, 그래도, 결코"	
軽々	かるがる	"가뿐히, 거뜬히"	
かんかん		"땡땡(소리), 쨍쨍(햇빛)"	
がんがん		"시끄럽게 잔소리함, 띵함"	
ぎざぎざ		들쭉날쭉	
きちんと		"깔끔히, 정확히"	
きっと		"꼭, 분명, 반드시"	
きょろきょろ		두리번두리번	
きらきら		반짝반짝	
ぐっすり		푹(깊이 잠든 모양)	
ぐるぐる		"빙글빙글, 둘둘"	
ぐんぐん		"부쩍부쩍, 쑥쑥"	
現に	げんに	"실제로, 지금"	
極	ごく	"극히, 대단히"	
こっそり		"가만히, 살짝, 몰래"	
ころころ		"대굴대굴, 오동통"	
さすが		"역시, 정말이지"	
さらさら		"졸졸, 보슬보슬"	
更に	さらに	"게다가, 더욱더"	
しいんと		"아주 조용함, 고요함"	
しかも		"게다가, 그 위에"	
始終	しじゅう	"내내, 늘, 항상"	
従って	したがって	"따라서, 그러므로"	
直に	じきに	"곧바로, 금방"	
しっかり		"단단히, 제대로, 야무지게"	
しっとり		"촉촉히, 차분히"	
しみじみ		"절실히, 곰곰이"	
順々に	じゅんじゅんに	"차례차례, 차례로"	
すいすい		"척척, 술술, 거침없이"	
すくすく		"쑥쑥, 무럭무럭"	
すっと		"불쑥, 쑥, 후련함, 개운함"	
既に	すでに	"이미, 벌써"	
すらすら		"술술, 척척, 거침없이"	
ずらり		"죽, 줄줄이"	
せっせと		"열심히, 부지런히"	
絶対に	ぜったいに	"절대로, 반드시, 결코"	
是非とも	ぜひとも	"꼭, 무슨 일이 있어도"	
そこで		"그래서, 그런데"	
そっと・そうっと		"살짝, 몰래"	
それからそれと		"뒤이어, 잇달아"	
それでも		"그런데도, 그래도"	
そろそろ		슬슬	
大して	たいして	"대단한, 이렇다 할, 특별한"	
大層	たいそう	"매우, 아주, 대단히"	
大半	たいはん	"태반, 대부분"	
大分	だいぶ・だいぶん	"상당히, 어지간히, 꽤"	
絶えず	たえず	"늘, 끊임없이"	
ただちに		"즉시, 당장, 직접"	
断固	だんこ	"단호히, 단연코"	
段々	だんだん	"차츰, 점차, 서서히"	
単に	たんに	"단지, 다만, 그저"	
近々	ちかぢか	"머지않아, 일간"	
ちょいちょい		"때때로, 가끔"	
ちょいと		"조금, 약간"	
つい		"그만, 무심코"	
次いで	ついで	"뒤이어, 잇따라서"	
ついに		"드디어, 마침내, 결국"	
つくづく		"곰곰이, 뚫어지게, 절실히"	
つるつる(と)		"매끈매끈, 반들반들"	
転々	てんてん	"전전, 여기저기 옮겨 다님"	
どうも		"도무지, 도저히, 아무래도"	
どきどき		"두근두근, 울렁울렁"	
所々	ところどころ	여기저기	
ともかく		"하여간, 어쨌든, 여하튼"	
何しろ	なにしろ	"어쨌든, 여하튼"	
何分	なにぶん	"아무쪼록, 부디"	
何とか	なんとか	"어떻게든, 간신히, 그럭저럭"	
何となく	なんとなく	"왠지, 어쩐지"	
何とも	なんとも	"정말, 뭐라고도"	
何の	なんの	"무슨, 어떤, 아무"	
残らず	のこらず	"남김 없이, 전부, 모두"	
のろのろ		"느릿느릿, 꾸물꾸물"	
はきはき		"시원시원, 또랑또랑"	
果たして	はたして	"과연, 역시, 대체"	
ばっさり		"싹둑, 싹"	
ばったり		"딱 마주침, 뚝 끊김"	
ぴったり		"꼭 맞음, 딱 맞음"	
一通り	ひととおり	"대강, 얼추, 대충"	
ひとまず		"우선, 일단"	
ひとりでに		"저절로, 자연히"	
広々	ひろびろ	널찍한 모양	
ぶつぶつ		"중얼중얼, 투덜투덜"	
ふと		"문득, 갑자기"	
ぶよぶよ		포동포동	
ふわふわ		"푹신푹신, 두둥실"	
ぷんぷん		"물씬, 뾰로통"	
ふんわり(と)		"폭신하게, 사뿐히"	
ぼうっと		"흐릿함, 희미함, 멍함"	
ほかほか		따끈따끈	
ぼつぼつ		"슬슬, 조금씩"	
ぼろぼろ		부슬부슬	
誠に	まことに	"참으로, 정말로"	
まごまご		우물쭈물	
まさか		"설마, 정말이지"	
まさに		"바로, 틀림없이, 정말로"	
むしろ		"차라리, 오히려"	
万一・万が一	まんいち・まんがいち	"만일, 만약"	
めちゃくちゃ		"아주, 엄청"	
めっきり		"뚜렷이, 현저히, 부쩍"	
めったに		"거의, 좀처럼"	
もしかしたら		어쩌면	
もしかして		"만약에, 어쩌면"	
もしも		"만약, 만일의 경우"	
もじもじ		"꾸물꾸물, 머뭇머뭇"	
元々	もともと	"본디부터, 원래"	
もはや		"이미, 벌써, 어느새"	
やがて		"머지않아, 이윽고"	
やたらに		"마구, 몹시, 함부로"	
ゆらゆら		"흔들흔들, 하늘하늘"	
要するに	ようするに	"요컨대, 결국"	
ようやく		"겨우, 간신히, 그제야"	
より一層	よりいっそう	"한층 더, 보다 더"	
喜んで	よろこんで	"기꺼이, 기쁘게"	
わくわく		"울렁울렁, 두근두근"	
アーケード		"아케이드, 상점가"	
アート		"아트, 예술, 미술"	
アイスクリーム		아이스크림	
アイテム		"아이템, 항목, 품목"	
アイボリー		"아이보리, 상아빛"	
アイロン		"아이론, 다리미"	
アウト		"밖, 실격"	
アクセス		"액세스, 접근, 교통편"	
アクセント		"악센트, 억양, 강조"	
アクティブ		"활동적임, 적극적임"	
アップ		"상승, 인상"	
アプローチ		"어프로치, 접근"	
アルファベット		알파벳	
アンテナ		안테나	
アンバランス		불균형함	
イージー		"간편함, 손쉬움"	
イコール		"같음, 등호"	
イベント		"이벤트, 행사"	
イメージ		"이미지, 인상"	
インストール		설치	
インタビュー		"인터뷰, 면접"	
インパクト		"임팩트, 충돌, 충격"	
ウイスキー		위스키	
ウーマン		"여성, 여자"	
ウール		"울, 양털, 모직물"	
ウエートレス		"웨이트리스, 여자 종업원"	
エアメール		항공 우편	
エチケット		"에티켓, 예의범절"	
エプロン		"에이프런, 앞치마"	
エンジニア		"엔지니어, 기술자"	
オーケストラ		"오케스트라, 관현악(단)"	
オリジナル		"원작, 독창적인"	
オルガン		오르간	
オンライン		온라인	
カーブ		"커브, 곡선, 굽음"	
ガイドブック		"가이드 북, 안내서"	
ガム		껌	
カラー		"컬러, 색, 색깔"	
キャプテン		"캡틴, 주장"	
ギャング		"갱, 강도(단)"	
キャンパス		"캠퍼스, 대학"	
キャンプ		"캠프, 야영"	
クイズ		퀴즈	
クラシック		"클래식, 고전"	
グラス		"유리컵, 안경"	
クラブ		클럽	
クリア		"깨끗함, 통과함"	
クリーニング		"세탁, 청소"	
クリスマス		크리스마스	
グループ		"그룹, 집단"	
クレジットカード		신용카드	
ケア		"주의, 조심, 돌봄, 보살핌"	
ゲスト		"게스트, 손님"	
コース		"코스, 진로, 방향"	
コーチ		"코치, 지도자"	
コード		"코드, 부호, 암호, 규정"	
コーラス		"코러스, 합창(단)"	
ゴール		"골, 목표, 목표를 달성함"	
コック		"요리사, 조리사"	
コピー		"카피, 복사, 사본"	
ゴム		고무	
コメント		"코멘트, 논평, 의견"	
コラム		칼럼	
コレクション		"컬렉션, 수집품"	
コンクリート		콘크리트	
コンセント		콘센트	
コントロール		"컨트롤, 통제, 조절"	
コンプレックス		콤플렉스	
サークル		"서클, 동아리, 동호회"	
サービス		서비스	
サイレン		"사이렌, 경적"	
サイン		"사인, 서명"	
シーツ		시트	
ジーンズ		"진, 청바지"	
ジェット		제트기	
シグナル		"시그널, 신호"	
システム		"시스템, 제도, 체계"	
ジャーナリスト		언론인	
シャッター		셔터	
ショップ		"상점, 가게"	
シリーズ		시리즈	
シンプル		"심플, 검소함, 단순함"	
スカーフ		스카프	
スタイル		"스타일, 모습, 모양, 양식"	
スタッフ		"스태프, 담당자, 제작진"	
スタミナ		"체력, 끈기"	
スタンド		"스탠드, 관람석, 판매대"	
スタンプ		"스탬프, 우편물의 소인"	
スチュワーデス		여자 승무원	
ステージ		"스테이지, 무대"	
ステーション		"정거장, 역"	
ステップ		"스텝, 걸음, 단계"	
ストッキング		스타킹	
ストップ		"정지, 멈춤, 정류소"	
ストライキ		파업	
スピーカー		스피커	
スピード		"스피드, 속도, 속력"	
スポーツカー		스포츠카	
スマート		"말쑥함, 단정하고 멋짐"	
スライド		"슬라이드, 미끄러짐"	
セット		"세트, 한 벌, 한쌍"	
セメント		시멘트	
センター		"센터, 중앙 기관"	
タイマー		"타이머, 스톱워치"	
タイム		"시각, 시간"	
ダイヤグラム		"운행표, 도표"	
ダイアモンド		다이아몬드	
ダイヤル		다이얼	
ダブル		"더블, 이중, 2배"	
ダム		댐	
ダメージ		"피해, 손해"	
タワー		"타워, 탑"	
チャージ		"충전, 요금"	
チョーク		"초크, 분필"	
チラシ		광고용 전단지	
データ		"데이터, 자료"	
テーマ		"테마, 주제"	
デモ		"데모, 시위"	
テント		"텐트, 천막"	
トップ		"톱, 정상, 선두, 1위"	
トラック		"트럭, 화물차"	
ドラマ		드라마	
トランプ		"트럼프, 카드"	
トレーニング		"트레이닝, 훈련, 연습"	
ドレス		드레스	
トン		"톤 (무게 단위), 1,000kg"	
トンネル		"터널, 굴"	
ナイロン		나일론	
ナンバー		번호	
ニーズ		"필요, 수요, 요구"	
ノルマ		"노르마, 할당량"	
バイオリン		바이올린	
パイプ		"파이프, 관"	
パイロット		"파일럿, 비행 조종사"	
バケツ		"양동이, 들통"	
パスポート		"패스포트, 여권"	
パターン		"패턴, 유형"	
パブリック		"공공적임, 대중적임"	
ハンサム		"핸섬, 미남임"	
パンツ		"팬츠, 바지"	
ハンドバッグ		핸드백	
ハンドル		"핸들, 손잡이"	
ピーク		"피크, 정상, 정점"	
ピストル		권총	
ビタミン		비타민	
ヒット		"히트, 큰 성공, (야구) 안타"	
ビニール		비닐	
ビルディング・ビル		빌딩	
ピン		핀	
フライパン		프라이팬	
プライベート		"개인적임, 사적임"	
ブラウス		블라우스	
ブラシ		"브러시, 솔"	
プラスチック		플라스틱	
フリー		"프리, 자유로움, 무료"	
ブレーキ		"브레이크, 제동(기)"	
フレッシュ		"신선함, 참신함"	
プロ		"프로, 전문적"	
フロア		"플로어, 층, 마룻바닥"	
ブローチ		브로치	
プログラム		"프로그램, 예정표"	
プロジェクト		"프로젝트, 계획"	
フロント		"프런트, 접수대"	
ペース		"페이스, 속도, 보조"	
ベスト		"베스트, 최선, 최고"	
ベテラン		"베테랑, 노련한 사람"	
ヘリコプター		"헬리콥터, 헬기"	
ベルト		"벨트, 혁대, 띠"	
ペンキ		페인트	
ベンチ		"벤치, 긴 의자"	
ペンチ		펜치	
ボーナス		"보너스, 상여금"	
マーケット		"마켓, 시장, 판로"	
マイク		마이크	
マイナス		"마이너스, 손해"	
マスク		"마스크, 가면, 탈"	
マスター		"마스터, 숙달함"	
マフラー		"머플러, 목도리"	
マラソン		마라톤	
マンション		"맨션, 중・고층 아파트"	
ミーティング		"미팅, 모임"	
ミシン		재봉틀	
ミス		"미스, 실패, 실수"	
メンバー		"멤버, 구성원"	
モーター		"모터, 전동기"	
モダン		"모던, 현대적임"	
モデル		"모델, 원형, 견본"	
モノレール		모노레일	
ヨーロッパ		유럽	
ヨット		요트	
ライター		라이터	
ライバル		"라이벌, 경쟁 상대"	
ライブ		"라이브, 생방송, 실황"	
ライフスタイル		생활 방식	
ライン		"라인, 선, 줄"	
ラウンジ		"라운지, 휴게실"	
ラウンド		"라운드, 둥긂, 일주, 순환"	
ラケット		라켓	
ランニング		"달리기, 러닝셔츠"	
リアル		"현실적임, 사실적임"	
リズム		리듬	
リットル		리터 (부피 단위)	
リボン		리본	
ルーズ		"느슨함, 야무지지 않음"	
レインコート		"레인코트, 우비"	
レクリエーション		"오락, 휴양"	
レンズ		렌즈	
ロケット		로켓	
ロッカー		"로커, 사물함, 보관함"	
ロビー		"로비, 휴게실"	
ワイン		"와인, 포도주"	
相次いで	あいついで	"이어서, 연달아"	
続々	ぞくぞく	속속	
相棒	あいぼう	"짝, 한패"	
パートナー		"파트너, 상대"	
明るい	あかるい	"밝다, 정통하다"	
詳しい	くわしい	"자세하다, 정통하다"	
あきらめ		"포기, 단념"	
絶望	ぜつぼう	절망	
空く	あく	"비다, 짬이 나다"	
済む	すむ	끝나다	
あくる日	あくるひ	"다음날, 익일"	
翌日	よくじつ	"다음날, 익일"	
当て	あて	"목표, 기대, 가망"	
見込み	みこみ	"전망, 예상, 목표"	
過ち	あやまち	"잘못, 실수"	
過失	かしつ	과실	
歩み	あゆみ	"걸음, 발걸음"	
歩行	ほこう	보행	
歩む	あゆむ	걷다	
歩く	あるく	걷다	
予め	あらかじめ	미리	
事前に	じぜんに	사전에	
争い	あらそい	"다툼, 논쟁"	
論争	ろんそう	논쟁	
言い訳	いいわけ	"변명, 핑계"	
弁解	べんかい	변명	
安易な	あんいな	"손쉬운, 안이한, 적당한"	
いわば		이른바	
たとえてみれば		예를 들면	
うまく		잘	
順調に	じゅんちょうに	순조롭게	
往々にして	おうおうにして	"왕왕, 이따금"	
時々	ときどき	"때때로, 가끔"	
大幅に	おおはばに	대폭적으로	
格段に	かくだんに	현격히	
ほぼ		"대략, 거의"	
押し出す	おしだす	"내세우다, 부각하다"	
一段と強く打ち出す	いちだんとつよくうちだす	한층 강하게 내세우다	
思い切って	おもいきって	과감히	
断然	だんぜん	단호히	
思わず	おもわず	무심코	
無意識に	むいしきに	무의식적으로	
掛かり	かかり	"비용, 경비"	
出費	しゅっぴ	지출	
賢い	かしこい	"현명하다, 영리하다"	
頭がいい	あたまがいい	머리가 좋다	
かつては		"일찍이, 예전에는"	
以前は	いぜんは	이전에는	
ギフト		선물	
贈り物	おくりもの	선물	
均衡	きんこう	균형	
バランス		"밸런스, 균형"	
個々	ここ	"개개, 각각, 각기"	
おのおの		"각각, 각기"	
それぞれ		"각각, 각기"	
心強い	こころづよい	마음 든든하다	
気丈夫だ	きじょうぶだ	마음이 든든하다	
こつ		요령	
要領	ようりょう	요령	
細かい	こまかい	"잘다, 세세하다"	
コンテナ		"컨테이너, 화물용 상자"	
入れ物	いれもの	용기	
差異	さい	차이	
違い	ちがい	"다름, 차이"	
ビジネス		"비즈니스, 사업"	
仕組み	しくみ	구조	
構造	こうぞう	구조	
支持	しじ	지지	
サポート		"서포트, 지지"	
視線	しせん	시선	
まなざし		"눈길, 시선, 눈빛"	
シナリオ		"시나리오, 각본"	
脚本	きゃくほん	각본	
ずいぶん		"꽤, 상당히"	
かなり		"꽤, 상당히"	
スケッチ		"스케치, 사생"	
写生	しゃせい	사생	
すべて		"모두, 전부"	
例え	たとえ	"비유, 예"	
比喩	ひゆ	비유	
たやすい		"쉽다, 용이하다"	
やさしい		쉽다	
結局	けっきょく	결국	
手を打つ	てをうつ	"타결하다, 매듭 짓다"	
どうせ		어차피	
トラブル		"트러블, 분쟁"	
もめごと		"분규, 분쟁"	
故障	こしょう	고장	
悩ます	なやます	괴롭히다	
苦しめる	くるしめる	괴롭히다	
にわかに		"즉각, 당장"	
すぐに		바로	
映える	はえる	"빛나다, 돋보이다"	
引き立つ	ひきたつ	"돋보이다, 두드러지다"	
パレード		"퍼레이드, 행진"	
行列	ぎょうれつ	행렬	
判明	はんめい	판명	
非常に	ひじょうに	"상당히, 매우"	
何の気なしに	なんのきなしに	아무 생각 없이	
へとへと		녹초가 됨	
くたくた		"나른함, 흐물흐물해짐"	
ポイント		"포인트, 요점"	
まもなく		"머지않아, 곧"	
もうすぐ		곧	
目録	もくろく	목록	
カタログ		"카탈로그, 목록"	
病	やまい	"병, 나쁜 버릇"	
つまり		"즉, 요컨대, 결국"	
ランキング		"랭킹, 순위"	
順位	じゅんい	순위	
ランプ		"램프, 전등"	
電灯	でんとう	전등	
レース		"레이스, 경주"	
競走	きょうそう	경주	
レッスン		"레슨, 수업, 연습"	
稽古	けいこ	"배움, 익힘, 연습"	
わずかに		"간신히, 겨우"	
かろうじて		"간신히, 겨우"	
やっと		"간신히, 겨우"	
